franchise.name,franchise.id,season.team.name,season,coach.order,coach.name,coach.id,coach.wins,coach.losses,coach.games
Atlanta Hawks,ATL,Tri-Cities Blackhawks,1950,1,R. Potter,pottero99c,1,6,7
Atlanta Hawks,ATL,Tri-Cities Blackhawks,1950,2,R. Auerbach,auerbre99c,28,29,57
Atlanta Hawks,ATL,Tri-Cities Blackhawks,1951,1,D. McMillan,mcmilda99c,9,14,23
Atlanta Hawks,ATL,Tri-Cities Blackhawks,1951,2,J. Logan,loganjo01c,2,1,3
Atlanta Hawks,ATL,Tri-Cities Blackhawks,1951,3,M. Todorovich,todormi01c,14,28,42
Atlanta Hawks,ATL,Milwaukee Hawks,1952,1,D. Moore,mooredo99c,17,49,66
Atlanta Hawks,ATL,Milwaukee Hawks,1953,1,A. Levane,levanan01c,27,44,71
Atlanta Hawks,ATL,Milwaukee Hawks,1954,1,A. Levane,levanan01c,11,35,46
Atlanta Hawks,ATL,Milwaukee Hawks,1954,2,R. Holzman,holzmre01c,10,16,26
Atlanta Hawks,ATL,Milwaukee Hawks,1955,1,R. Holzman,holzmre01c,26,46,72
Atlanta Hawks,ATL,St. Louis Hawks,1956,1,R. Holzman,holzmre01c,33,39,72
Atlanta Hawks,ATL,St. Louis Hawks,1957,1,R. Holzman,holzmre01c,14,19,33
Atlanta Hawks,ATL,St. Louis Hawks,1957,2,S. Martin,martisl01c,5,3,8
Atlanta Hawks,ATL,St. Louis Hawks,1957,3,A. Hannum,hannual01c,15,16,31
Atlanta Hawks,ATL,St. Louis Hawks,1958,1,A. Hannum,hannual01c,41,31,72
Atlanta Hawks,ATL,St. Louis Hawks,1959,1,A. Phillip,phillan01c,6,4,10
Atlanta Hawks,ATL,St. Louis Hawks,1959,2,E. Macauley,macaued01c,43,19,62
Atlanta Hawks,ATL,St. Louis Hawks,1960,1,E. Macauley,macaued01c,46,29,75
Atlanta Hawks,ATL,St. Louis Hawks,1961,1,P. Seymour,seymopa01c,51,28,79
Atlanta Hawks,ATL,St. Louis Hawks,1962,1,P. Seymour,seymopa01c,5,9,14
Atlanta Hawks,ATL,St. Louis Hawks,1962,2,A. Levane,levanan01c,20,40,60
Atlanta Hawks,ATL,St. Louis Hawks,1962,3,B. Pettit,pettibo01c,4,2,6
Atlanta Hawks,ATL,St. Louis Hawks,1963,1,H. Gallatin,gallaha01c,48,32,80
Atlanta Hawks,ATL,St. Louis Hawks,1964,1,H. Gallatin,gallaha01c,46,34,80
Atlanta Hawks,ATL,St. Louis Hawks,1965,1,H. Gallatin,gallaha01c,17,16,33
Atlanta Hawks,ATL,St. Louis Hawks,1965,2,R. Guerin,gueriri01c,28,19,47
Atlanta Hawks,ATL,St. Louis Hawks,1966,1,R. Guerin,gueriri01c,36,44,80
Atlanta Hawks,ATL,St. Louis Hawks,1967,1,R. Guerin,gueriri01c,39,42,81
Atlanta Hawks,ATL,St. Louis Hawks,1968,1,R. Guerin,gueriri01c,56,26,82
Atlanta Hawks,ATL,Atlanta Hawks,1969,1,R. Guerin,gueriri01c,48,34,82
Atlanta Hawks,ATL,Atlanta Hawks,1970,1,R. Guerin,gueriri01c,48,34,82
Atlanta Hawks,ATL,Atlanta Hawks,1971,1,R. Guerin,gueriri01c,36,46,82
Atlanta Hawks,ATL,Atlanta Hawks,1972,1,R. Guerin,gueriri01c,36,46,82
Atlanta Hawks,ATL,Atlanta Hawks,1973,1,C. Fitzsimmons,fitzsco99c,46,36,82
Atlanta Hawks,ATL,Atlanta Hawks,1974,1,C. Fitzsimmons,fitzsco99c,35,47,82
Atlanta Hawks,ATL,Atlanta Hawks,1975,1,C. Fitzsimmons,fitzsco99c,31,51,82
Atlanta Hawks,ATL,Atlanta Hawks,1976,1,C. Fitzsimmons,fitzsco99c,28,46,74
Atlanta Hawks,ATL,Atlanta Hawks,1976,2,G. Tormohlen,tormobu01c,1,7,8
Atlanta Hawks,ATL,Atlanta Hawks,1977,1,H. Brown,brownhu99c,31,51,82
Atlanta Hawks,ATL,Atlanta Hawks,1978,1,H. Brown,brownhu99c,41,41,82
Atlanta Hawks,ATL,Atlanta Hawks,1979,1,H. Brown,brownhu99c,46,36,82
Atlanta Hawks,ATL,Atlanta Hawks,1980,1,H. Brown,brownhu99c,50,32,82
Atlanta Hawks,ATL,Atlanta Hawks,1981,1,H. Brown,brownhu99c,31,48,79
Atlanta Hawks,ATL,Atlanta Hawks,1981,2,M. Fratello,fratemi99c,0,3,3
Atlanta Hawks,ATL,Atlanta Hawks,1982,1,K. Loughery,loughke01c,42,40,82
Atlanta Hawks,ATL,Atlanta Hawks,1983,1,K. Loughery,loughke01c,43,39,82
Atlanta Hawks,ATL,Atlanta Hawks,1984,1,M. Fratello,fratemi99c,40,42,82
Atlanta Hawks,ATL,Atlanta Hawks,1985,1,M. Fratello,fratemi99c,34,48,82
Atlanta Hawks,ATL,Atlanta Hawks,1986,1,M. Fratello,fratemi99c,50,32,82
Atlanta Hawks,ATL,Atlanta Hawks,1987,1,M. Fratello,fratemi99c,57,25,82
Atlanta Hawks,ATL,Atlanta Hawks,1988,1,M. Fratello,fratemi99c,50,32,82
Atlanta Hawks,ATL,Atlanta Hawks,1989,1,M. Fratello,fratemi99c,52,30,82
Atlanta Hawks,ATL,Atlanta Hawks,1990,1,M. Fratello,fratemi99c,41,41,82
Atlanta Hawks,ATL,Atlanta Hawks,1991,1,B. Weiss,weissbo01c,43,39,82
Atlanta Hawks,ATL,Atlanta Hawks,1992,1,B. Weiss,weissbo01c,38,44,82
Atlanta Hawks,ATL,Atlanta Hawks,1993,1,B. Weiss,weissbo01c,43,39,82
Atlanta Hawks,ATL,Atlanta Hawks,1994,1,L. Wilkens,wilkele01c,57,25,82
Atlanta Hawks,ATL,Atlanta Hawks,1995,1,L. Wilkens,wilkele01c,42,40,82
Atlanta Hawks,ATL,Atlanta Hawks,1996,1,L. Wilkens,wilkele01c,46,36,82
Atlanta Hawks,ATL,Atlanta Hawks,1997,1,L. Wilkens,wilkele01c,56,26,82
Atlanta Hawks,ATL,Atlanta Hawks,1998,1,L. Wilkens,wilkele01c,50,32,82
Atlanta Hawks,ATL,Atlanta Hawks,1999,1,L. Wilkens,wilkele01c,31,19,50
Atlanta Hawks,ATL,Atlanta Hawks,2000,1,L. Wilkens,wilkele01c,28,54,82
Atlanta Hawks,ATL,Atlanta Hawks,2001,1,L. Kruger,krugelo99c,25,57,82
Atlanta Hawks,ATL,Atlanta Hawks,2002,1,L. Kruger,krugelo99c,33,49,82
Atlanta Hawks,ATL,Atlanta Hawks,2003,1,L. Kruger,krugelo99c,11,16,27
Atlanta Hawks,ATL,Atlanta Hawks,2003,2,T. Stotts,stottte99c,24,31,55
Atlanta Hawks,ATL,Atlanta Hawks,2004,1,T. Stotts,stottte99c,28,54,82
Atlanta Hawks,ATL,Atlanta Hawks,2005,1,M. Woodson,woodsmi01c,13,69,82
Atlanta Hawks,ATL,Atlanta Hawks,2006,1,M. Woodson,woodsmi01c,26,56,82
Atlanta Hawks,ATL,Atlanta Hawks,2007,1,M. Woodson,woodsmi01c,30,52,82
Atlanta Hawks,ATL,Atlanta Hawks,2008,1,M. Woodson,woodsmi01c,37,45,82
Atlanta Hawks,ATL,Atlanta Hawks,2009,1,M. Woodson,woodsmi01c,47,35,82
Atlanta Hawks,ATL,Atlanta Hawks,2010,1,M. Woodson,woodsmi01c,53,29,82
Atlanta Hawks,ATL,Atlanta Hawks,2011,1,L. Drew,drewla01c,44,38,82
Atlanta Hawks,ATL,Atlanta Hawks,2012,1,L. Drew,drewla01c,40,26,66
Atlanta Hawks,ATL,Atlanta Hawks,2013,1,L. Drew,drewla01c,44,38,82
Atlanta Hawks,ATL,Atlanta Hawks,2014,1,M. Budenholzer,budenmi99c,38,44,82
Atlanta Hawks,ATL,Atlanta Hawks,2015,1,M. Budenholzer,budenmi99c,60,22,82
Atlanta Hawks,ATL,Atlanta Hawks,2016,1,M. Budenholzer,budenmi99c,48,34,82
Atlanta Hawks,ATL,Atlanta Hawks,2017,1,M. Budenholzer,budenmi99c,43,39,82
Atlanta Hawks,ATL,Atlanta Hawks,2018,1,M. Budenholzer,budenmi99c,24,58,82
Atlanta Hawks,ATL,Atlanta Hawks,2019,1,L. Pierce,piercll01c,29,53,82
Atlanta Hawks,ATL,Atlanta Hawks,2020,1,L. Pierce,piercll01c,20,47,67
Boston Celtics,BOS,Boston Celtics,1947,1,J. Russell,russejo99c,22,38,60
Boston Celtics,BOS,Boston Celtics,1948,1,J. Russell,russejo99c,20,28,48
Boston Celtics,BOS,Boston Celtics,1949,1,A. Julian,juliaal99c,25,35,60
Boston Celtics,BOS,Boston Celtics,1950,1,A. Julian,juliaal99c,22,46,68
Boston Celtics,BOS,Boston Celtics,1951,1,R. Auerbach,auerbre99c,39,30,69
Boston Celtics,BOS,Boston Celtics,1952,1,R. Auerbach,auerbre99c,39,27,66
Boston Celtics,BOS,Boston Celtics,1953,1,R. Auerbach,auerbre99c,46,25,71
Boston Celtics,BOS,Boston Celtics,1954,1,R. Auerbach,auerbre99c,42,30,72
Boston Celtics,BOS,Boston Celtics,1955,1,R. Auerbach,auerbre99c,36,36,72
Boston Celtics,BOS,Boston Celtics,1956,1,R. Auerbach,auerbre99c,39,33,72
Boston Celtics,BOS,Boston Celtics,1957,1,R. Auerbach,auerbre99c,44,28,72
Boston Celtics,BOS,Boston Celtics,1958,1,R. Auerbach,auerbre99c,49,23,72
Boston Celtics,BOS,Boston Celtics,1959,1,R. Auerbach,auerbre99c,52,20,72
Boston Celtics,BOS,Boston Celtics,1960,1,R. Auerbach,auerbre99c,59,16,75
Boston Celtics,BOS,Boston Celtics,1961,1,R. Auerbach,auerbre99c,57,22,79
Boston Celtics,BOS,Boston Celtics,1962,1,R. Auerbach,auerbre99c,60,20,80
Boston Celtics,BOS,Boston Celtics,1963,1,R. Auerbach,auerbre99c,58,22,80
Boston Celtics,BOS,Boston Celtics,1964,1,R. Auerbach,auerbre99c,59,21,80
Boston Celtics,BOS,Boston Celtics,1965,1,R. Auerbach,auerbre99c,62,18,80
Boston Celtics,BOS,Boston Celtics,1966,1,R. Auerbach,auerbre99c,54,26,80
Boston Celtics,BOS,Boston Celtics,1967,1,B. Russell,russebi01c,60,21,81
Boston Celtics,BOS,Boston Celtics,1968,1,B. Russell,russebi01c,54,28,82
Boston Celtics,BOS,Boston Celtics,1969,1,B. Russell,russebi01c,48,34,82
Boston Celtics,BOS,Boston Celtics,1970,1,T. Heinsohn,heinsto01c,34,48,82
Boston Celtics,BOS,Boston Celtics,1971,1,T. Heinsohn,heinsto01c,44,38,82
Boston Celtics,BOS,Boston Celtics,1972,1,T. Heinsohn,heinsto01c,56,26,82
Boston Celtics,BOS,Boston Celtics,1973,1,T. Heinsohn,heinsto01c,68,14,82
Boston Celtics,BOS,Boston Celtics,1974,1,T. Heinsohn,heinsto01c,56,26,82
Boston Celtics,BOS,Boston Celtics,1975,1,T. Heinsohn,heinsto01c,60,22,82
Boston Celtics,BOS,Boston Celtics,1976,1,T. Heinsohn,heinsto01c,54,28,82
Boston Celtics,BOS,Boston Celtics,1977,1,T. Heinsohn,heinsto01c,44,38,82
Boston Celtics,BOS,Boston Celtics,1978,1,T. Heinsohn,heinsto01c,11,23,34
Boston Celtics,BOS,Boston Celtics,1978,2,T. Sanders,sandeto01c,21,27,48
Boston Celtics,BOS,Boston Celtics,1979,1,T. Sanders,sandeto01c,2,12,14
Boston Celtics,BOS,Boston Celtics,1979,2,D. Cowens,cowenda01c,27,41,68
Boston Celtics,BOS,Boston Celtics,1980,1,B. Fitch,fitchbi99c,61,21,82
Boston Celtics,BOS,Boston Celtics,1981,1,B. Fitch,fitchbi99c,62,20,82
Boston Celtics,BOS,Boston Celtics,1982,1,B. Fitch,fitchbi99c,63,19,82
Boston Celtics,BOS,Boston Celtics,1983,1,B. Fitch,fitchbi99c,56,26,82
Boston Celtics,BOS,Boston Celtics,1984,1,K. Jones,joneskc01c,62,20,82
Boston Celtics,BOS,Boston Celtics,1985,1,K. Jones,joneskc01c,63,19,82
Boston Celtics,BOS,Boston Celtics,1986,1,K. Jones,joneskc01c,67,15,82
Boston Celtics,BOS,Boston Celtics,1987,1,K. Jones,joneskc01c,59,23,82
Boston Celtics,BOS,Boston Celtics,1988,1,K. Jones,joneskc01c,57,25,82
Boston Celtics,BOS,Boston Celtics,1989,1,J. Rodgers,rodgeji99c,42,40,82
Boston Celtics,BOS,Boston Celtics,1990,1,J. Rodgers,rodgeji99c,52,30,82
Boston Celtics,BOS,Boston Celtics,1991,1,C. Ford,fordch01c,56,26,82
Boston Celtics,BOS,Boston Celtics,1992,1,C. Ford,fordch01c,51,31,82
Boston Celtics,BOS,Boston Celtics,1993,1,C. Ford,fordch01c,48,34,82
Boston Celtics,BOS,Boston Celtics,1994,1,C. Ford,fordch01c,32,50,82
Boston Celtics,BOS,Boston Celtics,1995,1,C. Ford,fordch01c,35,47,82
Boston Celtics,BOS,Boston Celtics,1996,1,M. Carr,carrml01c,33,49,82
Boston Celtics,BOS,Boston Celtics,1997,1,M. Carr,carrml01c,15,67,82
Boston Celtics,BOS,Boston Celtics,1998,1,R. Pitino,pitinri99c,36,46,82
Boston Celtics,BOS,Boston Celtics,1999,1,R. Pitino,pitinri99c,19,31,50
Boston Celtics,BOS,Boston Celtics,2000,1,R. Pitino,pitinri99c,35,47,82
Boston Celtics,BOS,Boston Celtics,2001,1,R. Pitino,pitinri99c,12,22,34
Boston Celtics,BOS,Boston Celtics,2001,2,J. O'Brien,obrieji99c,24,24,48
Boston Celtics,BOS,Boston Celtics,2002,1,J. O'Brien,obrieji99c,49,33,82
Boston Celtics,BOS,Boston Celtics,2003,1,J. O'Brien,obrieji99c,44,38,82
Boston Celtics,BOS,Boston Celtics,2004,1,J. O'Brien,obrieji99c,22,24,46
Boston Celtics,BOS,Boston Celtics,2004,2,J. Carroll,carrojo99c,14,22,36
Boston Celtics,BOS,Boston Celtics,2005,1,D. Rivers,riverdo01c,45,37,82
Boston Celtics,BOS,Boston Celtics,2006,1,D. Rivers,riverdo01c,33,49,82
Boston Celtics,BOS,Boston Celtics,2007,1,D. Rivers,riverdo01c,24,58,82
Boston Celtics,BOS,Boston Celtics,2008,1,D. Rivers,riverdo01c,66,16,82
Boston Celtics,BOS,Boston Celtics,2009,1,D. Rivers,riverdo01c,62,20,82
Boston Celtics,BOS,Boston Celtics,2010,1,D. Rivers,riverdo01c,50,32,82
Boston Celtics,BOS,Boston Celtics,2011,1,D. Rivers,riverdo01c,56,26,82
Boston Celtics,BOS,Boston Celtics,2012,1,D. Rivers,riverdo01c,39,27,66
Boston Celtics,BOS,Boston Celtics,2013,1,D. Rivers,riverdo01c,41,40,81
Boston Celtics,BOS,Boston Celtics,2014,1,B. Stevens,stevebr99c,25,57,82
Boston Celtics,BOS,Boston Celtics,2015,1,B. Stevens,stevebr99c,40,42,82
Boston Celtics,BOS,Boston Celtics,2016,1,B. Stevens,stevebr99c,48,34,82
Boston Celtics,BOS,Boston Celtics,2017,1,B. Stevens,stevebr99c,53,29,82
Boston Celtics,BOS,Boston Celtics,2018,1,B. Stevens,stevebr99c,55,27,82
Boston Celtics,BOS,Boston Celtics,2019,1,B. Stevens,stevebr99c,49,33,82
Boston Celtics,BOS,Boston Celtics,2020,1,B. Stevens,stevebr99c,43,21,64
Brooklyn Nets,NJN,New Jersey Americans,1968,1,M. Zaslofsky,zasloma01c,36,42,78
Brooklyn Nets,NJN,New York Nets,1969,1,M. Zaslofsky,zasloma01c,17,61,78
Brooklyn Nets,NJN,New York Nets,1970,1,Y. Larese,laresyo01c,39,45,84
Brooklyn Nets,NJN,New York Nets,1971,1,L. Carnesecca,carnelo99c,40,44,84
Brooklyn Nets,NJN,New York Nets,1972,1,L. Carnesecca,carnelo99c,44,40,84
Brooklyn Nets,NJN,New York Nets,1973,1,L. Carnesecca,carnelo99c,30,54,84
Brooklyn Nets,NJN,New York Nets,1974,1,K. Loughery,loughke01c,55,29,84
Brooklyn Nets,NJN,New York Nets,1975,1,K. Loughery,loughke01c,58,26,84
Brooklyn Nets,NJN,New York Nets,1976,1,K. Loughery,loughke01c,55,29,84
Brooklyn Nets,NJN,New York Nets,1977,1,K. Loughery,loughke01c,22,60,82
Brooklyn Nets,NJN,New Jersey Nets,1978,1,K. Loughery,loughke01c,24,58,82
Brooklyn Nets,NJN,New Jersey Nets,1979,1,K. Loughery,loughke01c,37,45,82
Brooklyn Nets,NJN,New Jersey Nets,1980,1,K. Loughery,loughke01c,34,48,82
Brooklyn Nets,NJN,New Jersey Nets,1981,1,K. Loughery,loughke01c,12,23,35
Brooklyn Nets,NJN,New Jersey Nets,1981,2,B. MacKinnon,mackibo99c,12,35,47
Brooklyn Nets,NJN,New Jersey Nets,1982,1,L. Brown,brownla01c,44,38,82
Brooklyn Nets,NJN,New Jersey Nets,1983,1,L. Brown,brownla01c,47,29,76
Brooklyn Nets,NJN,New Jersey Nets,1983,2,B. Blair,blairbi99c,2,4,6
Brooklyn Nets,NJN,New Jersey Nets,1984,1,S. Albeck,albecst99c,45,37,82
Brooklyn Nets,NJN,New Jersey Nets,1985,1,S. Albeck,albecst99c,42,40,82
Brooklyn Nets,NJN,New Jersey Nets,1986,1,D. Wohl,wohlda01c,39,43,82
Brooklyn Nets,NJN,New Jersey Nets,1987,1,D. Wohl,wohlda01c,24,58,82
Brooklyn Nets,NJN,New Jersey Nets,1988,1,D. Wohl,wohlda01c,2,13,15
Brooklyn Nets,NJN,New Jersey Nets,1988,2,B. MacKinnon,mackibo99c,10,29,39
Brooklyn Nets,NJN,New Jersey Nets,1988,3,W. Reed,reedwi01c,7,21,28
Brooklyn Nets,NJN,New Jersey Nets,1989,1,W. Reed,reedwi01c,26,56,82
Brooklyn Nets,NJN,New Jersey Nets,1990,1,B. Fitch,fitchbi99c,17,65,82
Brooklyn Nets,NJN,New Jersey Nets,1991,1,B. Fitch,fitchbi99c,26,56,82
Brooklyn Nets,NJN,New Jersey Nets,1992,1,B. Fitch,fitchbi99c,40,42,82
Brooklyn Nets,NJN,New Jersey Nets,1993,1,C. Daly,dalych99c,43,39,82
Brooklyn Nets,NJN,New Jersey Nets,1994,1,C. Daly,dalych99c,45,37,82
Brooklyn Nets,NJN,New Jersey Nets,1995,1,B. Beard,beardbu01c,30,52,82
Brooklyn Nets,NJN,New Jersey Nets,1996,1,B. Beard,beardbu01c,30,52,82
Brooklyn Nets,NJN,New Jersey Nets,1997,1,J. Calipari,calipjo99c,26,56,82
Brooklyn Nets,NJN,New Jersey Nets,1998,1,J. Calipari,calipjo99c,43,39,82
Brooklyn Nets,NJN,New Jersey Nets,1999,1,J. Calipari,calipjo99c,3,17,20
Brooklyn Nets,NJN,New Jersey Nets,1999,2,D. Casey,caseybo99c,13,17,30
Brooklyn Nets,NJN,New Jersey Nets,2000,1,D. Casey,caseybo99c,31,51,82
Brooklyn Nets,NJN,New Jersey Nets,2001,1,B. Scott,scottby01c,26,56,82
Brooklyn Nets,NJN,New Jersey Nets,2002,1,B. Scott,scottby01c,52,30,82
Brooklyn Nets,NJN,New Jersey Nets,2003,1,B. Scott,scottby01c,49,33,82
Brooklyn Nets,NJN,New Jersey Nets,2004,1,B. Scott,scottby01c,22,20,42
Brooklyn Nets,NJN,New Jersey Nets,2004,2,L. Frank,frankla99c,25,15,40
Brooklyn Nets,NJN,New Jersey Nets,2005,1,L. Frank,frankla99c,42,40,82
Brooklyn Nets,NJN,New Jersey Nets,2006,1,L. Frank,frankla99c,49,33,82
Brooklyn Nets,NJN,New Jersey Nets,2007,1,L. Frank,frankla99c,41,41,82
Brooklyn Nets,NJN,New Jersey Nets,2008,1,L. Frank,frankla99c,34,48,82
Brooklyn Nets,NJN,New Jersey Nets,2009,1,L. Frank,frankla99c,34,48,82
Brooklyn Nets,NJN,New Jersey Nets,2010,1,L. Frank,frankla99c,0,16,16
Brooklyn Nets,NJN,New Jersey Nets,2010,2,T. Barrise,barrito99c,0,2,2
Brooklyn Nets,NJN,New Jersey Nets,2010,3,K. Vandeweghe,vandeki01c,12,52,64
Brooklyn Nets,NJN,New Jersey Nets,2011,1,A. Johnson,johnsav01c,24,58,82
Brooklyn Nets,NJN,New Jersey Nets,2012,1,A. Johnson,johnsav01c,22,44,66
Brooklyn Nets,NJN,Brooklyn Nets,2013,1,A. Johnson,johnsav01c,14,14,28
Brooklyn Nets,NJN,Brooklyn Nets,2013,2,P. Carlesimo,carlepj99c,35,19,54
Brooklyn Nets,NJN,Brooklyn Nets,2014,1,J. Kidd,kiddja01c,44,38,82
Brooklyn Nets,NJN,Brooklyn Nets,2015,1,L. Hollins,hollili01c,38,44,82
Brooklyn Nets,NJN,Brooklyn Nets,2016,1,L. Hollins,hollili01c,10,27,37
Brooklyn Nets,NJN,Brooklyn Nets,2016,2,T. Brown,brownto01c,11,34,45
Brooklyn Nets,NJN,Brooklyn Nets,2017,1,K. Atkinson,atkinke01c,20,62,82
Brooklyn Nets,NJN,Brooklyn Nets,2018,1,K. Atkinson,atkinke01c,28,54,82
Brooklyn Nets,NJN,Brooklyn Nets,2019,1,K. Atkinson,atkinke01c,42,40,82
Brooklyn Nets,NJN,Brooklyn Nets,2020,1,K. Atkinson,atkinke01c,28,34,62
Brooklyn Nets,NJN,Brooklyn Nets,2020,2,J. Vaughn,vaughja01c,2,0,2
Charlotte Hornets,CHA,Charlotte Hornets,1989,1,D. Harter,hartedi99c,20,62,82
Charlotte Hornets,CHA,Charlotte Hornets,1990,1,D. Harter,hartedi99c,8,32,40
Charlotte Hornets,CHA,Charlotte Hornets,1990,2,G. Littles,littlge01c,11,31,42
Charlotte Hornets,CHA,Charlotte Hornets,1991,1,G. Littles,littlge01c,26,56,82
Charlotte Hornets,CHA,Charlotte Hornets,1992,1,A. Bristow,bristal01c,31,51,82
Charlotte Hornets,CHA,Charlotte Hornets,1993,1,A. Bristow,bristal01c,44,38,82
Charlotte Hornets,CHA,Charlotte Hornets,1994,1,A. Bristow,bristal01c,41,41,82
Charlotte Hornets,CHA,Charlotte Hornets,1995,1,A. Bristow,bristal01c,50,32,82
Charlotte Hornets,CHA,Charlotte Hornets,1996,1,A. Bristow,bristal01c,41,41,82
Charlotte Hornets,CHA,Charlotte Hornets,1997,1,D. Cowens,cowenda01c,54,28,82
Charlotte Hornets,CHA,Charlotte Hornets,1998,1,D. Cowens,cowenda01c,51,31,82
Charlotte Hornets,CHA,Charlotte Hornets,1999,1,D. Cowens,cowenda01c,4,11,15
Charlotte Hornets,CHA,Charlotte Hornets,1999,2,P. Silas,silaspa01c,22,13,35
Charlotte Hornets,CHA,Charlotte Hornets,2000,1,P. Silas,silaspa01c,49,33,82
Charlotte Hornets,CHA,Charlotte Hornets,2001,1,P. Silas,silaspa01c,46,36,82
Charlotte Hornets,CHA,Charlotte Hornets,2002,1,P. Silas,silaspa01c,44,38,82
Charlotte Hornets,CHA,Charlotte Bobcats,2005,1,B. Bickerstaff,bickebe99c,18,64,82
Charlotte Hornets,CHA,Charlotte Bobcats,2006,1,B. Bickerstaff,bickebe99c,26,56,82
Charlotte Hornets,CHA,Charlotte Bobcats,2007,1,B. Bickerstaff,bickebe99c,33,49,82
Charlotte Hornets,CHA,Charlotte Bobcats,2008,1,S. Vincent,vincesa01c,32,50,82
Charlotte Hornets,CHA,Charlotte Bobcats,2009,1,L. Brown,brownla01c,35,47,82
Charlotte Hornets,CHA,Charlotte Bobcats,2010,1,L. Brown,brownla01c,44,38,82
Charlotte Hornets,CHA,Charlotte Bobcats,2011,1,L. Brown,brownla01c,9,19,28
Charlotte Hornets,CHA,Charlotte Bobcats,2011,2,P. Silas,silaspa01c,25,29,54
Charlotte Hornets,CHA,Charlotte Bobcats,2012,1,P. Silas,silaspa01c,7,59,66
Charlotte Hornets,CHA,Charlotte Bobcats,2013,1,M. Dunlap,dunlami99c,21,61,82
Charlotte Hornets,CHA,Charlotte Bobcats,2014,1,S. Clifford,cliffst99c,43,39,82
Charlotte Hornets,CHA,Charlotte Hornets,2015,1,S. Clifford,cliffst99c,33,49,82
Charlotte Hornets,CHA,Charlotte Hornets,2016,1,S. Clifford,cliffst99c,48,34,82
Charlotte Hornets,CHA,Charlotte Hornets,2017,1,S. Clifford,cliffst99c,36,46,82
Charlotte Hornets,CHA,Charlotte Hornets,2018,1,S. Clifford,cliffst99c,36,46,82
Charlotte Hornets,CHA,Charlotte Hornets,2019,1,J. Borrego,borreja99c,39,43,82
Charlotte Hornets,CHA,Charlotte Hornets,2020,1,J. Borrego,borreja99c,23,42,65
Chicago Bulls,CHI,Chicago Bulls,1967,1,R. Kerr,kerrre01c,33,48,81
Chicago Bulls,CHI,Chicago Bulls,1968,1,R. Kerr,kerrre01c,29,53,82
Chicago Bulls,CHI,Chicago Bulls,1969,1,D. Motta,mottadi99c,33,49,82
Chicago Bulls,CHI,Chicago Bulls,1970,1,D. Motta,mottadi99c,39,43,82
Chicago Bulls,CHI,Chicago Bulls,1971,1,D. Motta,mottadi99c,51,31,82
Chicago Bulls,CHI,Chicago Bulls,1972,1,D. Motta,mottadi99c,57,25,82
Chicago Bulls,CHI,Chicago Bulls,1973,1,D. Motta,mottadi99c,51,31,82
Chicago Bulls,CHI,Chicago Bulls,1974,1,D. Motta,mottadi99c,54,28,82
Chicago Bulls,CHI,Chicago Bulls,1975,1,D. Motta,mottadi99c,47,35,82
Chicago Bulls,CHI,Chicago Bulls,1976,1,D. Motta,mottadi99c,24,58,82
Chicago Bulls,CHI,Chicago Bulls,1977,1,E. Badger,badgeed99c,44,38,82
Chicago Bulls,CHI,Chicago Bulls,1978,1,E. Badger,badgeed99c,40,42,82
Chicago Bulls,CHI,Chicago Bulls,1979,1,L. Costello,costela01c,20,36,56
Chicago Bulls,CHI,Chicago Bulls,1979,2,S. Robertson,robersc99c,11,15,26
Chicago Bulls,CHI,Chicago Bulls,1980,1,J. Sloan,sloanje01c,30,52,82
Chicago Bulls,CHI,Chicago Bulls,1981,1,J. Sloan,sloanje01c,45,37,82
Chicago Bulls,CHI,Chicago Bulls,1982,1,J. Sloan,sloanje01c,19,32,51
Chicago Bulls,CHI,Chicago Bulls,1982,2,P. Johnson,johnsph99c,0,1,1
Chicago Bulls,CHI,Chicago Bulls,1982,3,R. Thorn,thornro01c,15,15,30
Chicago Bulls,CHI,Chicago Bulls,1983,1,P. Westhead,westhpa99c,28,54,82
Chicago Bulls,CHI,Chicago Bulls,1984,1,K. Loughery,loughke01c,27,55,82
Chicago Bulls,CHI,Chicago Bulls,1985,1,K. Loughery,loughke01c,38,44,82
Chicago Bulls,CHI,Chicago Bulls,1986,1,S. Albeck,albecst99c,30,52,82
Chicago Bulls,CHI,Chicago Bulls,1987,1,D. Collins,collido01c,40,42,82
Chicago Bulls,CHI,Chicago Bulls,1988,1,D. Collins,collido01c,50,32,82
Chicago Bulls,CHI,Chicago Bulls,1989,1,D. Collins,collido01c,47,35,82
Chicago Bulls,CHI,Chicago Bulls,1990,1,P. Jackson,jacksph01c,55,27,82
Chicago Bulls,CHI,Chicago Bulls,1991,1,P. Jackson,jacksph01c,61,21,82
Chicago Bulls,CHI,Chicago Bulls,1992,1,P. Jackson,jacksph01c,67,15,82
Chicago Bulls,CHI,Chicago Bulls,1993,1,P. Jackson,jacksph01c,57,25,82
Chicago Bulls,CHI,Chicago Bulls,1994,1,P. Jackson,jacksph01c,55,27,82
Chicago Bulls,CHI,Chicago Bulls,1995,1,P. Jackson,jacksph01c,47,35,82
Chicago Bulls,CHI,Chicago Bulls,1996,1,P. Jackson,jacksph01c,72,10,82
Chicago Bulls,CHI,Chicago Bulls,1997,1,P. Jackson,jacksph01c,69,13,82
Chicago Bulls,CHI,Chicago Bulls,1998,1,P. Jackson,jacksph01c,62,20,82
Chicago Bulls,CHI,Chicago Bulls,1999,1,T. Floyd,floydti99c,13,37,50
Chicago Bulls,CHI,Chicago Bulls,2000,1,T. Floyd,floydti99c,17,65,82
Chicago Bulls,CHI,Chicago Bulls,2001,1,T. Floyd,floydti99c,15,67,82
Chicago Bulls,CHI,Chicago Bulls,2002,1,T. Floyd,floydti99c,4,21,25
Chicago Bulls,CHI,Chicago Bulls,2002,2,B. Berry,berrybi99c,0,2,2
Chicago Bulls,CHI,Chicago Bulls,2002,3,B. Cartwright,cartwbi01c,17,38,55
Chicago Bulls,CHI,Chicago Bulls,2003,1,B. Cartwright,cartwbi01c,30,52,82
Chicago Bulls,CHI,Chicago Bulls,2004,1,B. Cartwright,cartwbi01c,4,10,14
Chicago Bulls,CHI,Chicago Bulls,2004,2,P. Myers,myerspe01c,0,2,2
Chicago Bulls,CHI,Chicago Bulls,2004,3,S. Skiles,skilesc01c,19,47,66
Chicago Bulls,CHI,Chicago Bulls,2005,1,S. Skiles,skilesc01c,47,35,82
Chicago Bulls,CHI,Chicago Bulls,2006,1,S. Skiles,skilesc01c,41,41,82
Chicago Bulls,CHI,Chicago Bulls,2007,1,S. Skiles,skilesc01c,49,33,82
Chicago Bulls,CHI,Chicago Bulls,2008,1,S. Skiles,skilesc01c,9,16,25
Chicago Bulls,CHI,Chicago Bulls,2008,2,P. Myers,myerspe01c,0,1,1
Chicago Bulls,CHI,Chicago Bulls,2008,3,J. Boylan,boylaji99c,24,32,56
Chicago Bulls,CHI,Chicago Bulls,2009,1,V. Del Negro,delnevi01c,41,41,82
Chicago Bulls,CHI,Chicago Bulls,2010,1,V. Del Negro,delnevi01c,41,41,82
Chicago Bulls,CHI,Chicago Bulls,2011,1,T. Thibodeau,thiboto99c,62,20,82
Chicago Bulls,CHI,Chicago Bulls,2012,1,T. Thibodeau,thiboto99c,50,16,66
Chicago Bulls,CHI,Chicago Bulls,2013,1,T. Thibodeau,thiboto99c,45,37,82
Chicago Bulls,CHI,Chicago Bulls,2014,1,T. Thibodeau,thiboto99c,48,34,82
Chicago Bulls,CHI,Chicago Bulls,2015,1,T. Thibodeau,thiboto99c,50,32,82
Chicago Bulls,CHI,Chicago Bulls,2016,1,F. Hoiberg,hoibefr99c,42,40,82
Chicago Bulls,CHI,Chicago Bulls,2017,1,F. Hoiberg,hoibefr99c,41,41,82
Chicago Bulls,CHI,Chicago Bulls,2018,1,F. Hoiberg,hoibefr99c,27,55,82
Chicago Bulls,CHI,Chicago Bulls,2019,1,F. Hoiberg,hoibefr99c,5,19,24
Chicago Bulls,CHI,Chicago Bulls,2019,2,J. Boylen,boyleji02c,17,41,58
Chicago Bulls,CHI,Chicago Bulls,2020,1,J. Boylen,boyleji02c,22,43,65
Cleveland Cavaliers,CLE,Cleveland Cavaliers,1971,1,B. Fitch,fitchbi99c,15,67,82
Cleveland Cavaliers,CLE,Cleveland Cavaliers,1972,1,B. Fitch,fitchbi99c,23,59,82
Cleveland Cavaliers,CLE,Cleveland Cavaliers,1973,1,B. Fitch,fitchbi99c,32,50,82
Cleveland Cavaliers,CLE,Cleveland Cavaliers,1974,1,B. Fitch,fitchbi99c,29,53,82
Cleveland Cavaliers,CLE,Cleveland Cavaliers,1975,1,B. Fitch,fitchbi99c,40,42,82
Cleveland Cavaliers,CLE,Cleveland Cavaliers,1976,1,B. Fitch,fitchbi99c,49,33,82
Cleveland Cavaliers,CLE,Cleveland Cavaliers,1977,1,B. Fitch,fitchbi99c,43,39,82
Cleveland Cavaliers,CLE,Cleveland Cavaliers,1978,1,B. Fitch,fitchbi99c,43,39,82
Cleveland Cavaliers,CLE,Cleveland Cavaliers,1979,1,B. Fitch,fitchbi99c,30,52,82
Cleveland Cavaliers,CLE,Cleveland Cavaliers,1980,1,S. Albeck,albecst99c,37,45,82
Cleveland Cavaliers,CLE,Cleveland Cavaliers,1981,1,B. Musselman,mussebi99c,25,46,71
Cleveland Cavaliers,CLE,Cleveland Cavaliers,1981,2,D. Delaney,delando99c,3,8,11
Cleveland Cavaliers,CLE,Cleveland Cavaliers,1982,1,D. Delaney,delando99c,4,11,15
Cleveland Cavaliers,CLE,Cleveland Cavaliers,1982,2,B. Kloppenburg,kloppbo99c,0,3,3
Cleveland Cavaliers,CLE,Cleveland Cavaliers,1982,3,C. Daly,dalych99c,9,32,41
Cleveland Cavaliers,CLE,Cleveland Cavaliers,1982,4,B. Musselman,mussebi99c,2,21,23
Cleveland Cavaliers,CLE,Cleveland Cavaliers,1983,1,T. Nissalke,nissato99c,23,59,82
Cleveland Cavaliers,CLE,Cleveland Cavaliers,1984,1,T. Nissalke,nissato99c,28,54,82
Cleveland Cavaliers,CLE,Cleveland Cavaliers,1985,1,G. Karl,karlge01c,36,46,82
Cleveland Cavaliers,CLE,Cleveland Cavaliers,1986,1,G. Karl,karlge01c,25,42,67
Cleveland Cavaliers,CLE,Cleveland Cavaliers,1986,2,G. Littles,littlge01c,4,11,15
Cleveland Cavaliers,CLE,Cleveland Cavaliers,1987,1,L. Wilkens,wilkele01c,31,51,82
Cleveland Cavaliers,CLE,Cleveland Cavaliers,1988,1,L. Wilkens,wilkele01c,42,40,82
Cleveland Cavaliers,CLE,Cleveland Cavaliers,1989,1,L. Wilkens,wilkele01c,57,25,82
Cleveland Cavaliers,CLE,Cleveland Cavaliers,1990,1,L. Wilkens,wilkele01c,42,40,82
Cleveland Cavaliers,CLE,Cleveland Cavaliers,1991,1,L. Wilkens,wilkele01c,33,49,82
Cleveland Cavaliers,CLE,Cleveland Cavaliers,1992,1,L. Wilkens,wilkele01c,57,25,82
Cleveland Cavaliers,CLE,Cleveland Cavaliers,1993,1,L. Wilkens,wilkele01c,54,28,82
Cleveland Cavaliers,CLE,Cleveland Cavaliers,1994,1,M. Fratello,fratemi99c,47,35,82
Cleveland Cavaliers,CLE,Cleveland Cavaliers,1995,1,M. Fratello,fratemi99c,43,39,82
Cleveland Cavaliers,CLE,Cleveland Cavaliers,1996,1,M. Fratello,fratemi99c,47,35,82
Cleveland Cavaliers,CLE,Cleveland Cavaliers,1997,1,M. Fratello,fratemi99c,42,40,82
Cleveland Cavaliers,CLE,Cleveland Cavaliers,1998,1,M. Fratello,fratemi99c,47,35,82
Cleveland Cavaliers,CLE,Cleveland Cavaliers,1999,1,M. Fratello,fratemi99c,22,28,50
Cleveland Cavaliers,CLE,Cleveland Cavaliers,2000,1,R. Wittman,wittmra01c,32,50,82
Cleveland Cavaliers,CLE,Cleveland Cavaliers,2001,1,R. Wittman,wittmra01c,30,52,82
Cleveland Cavaliers,CLE,Cleveland Cavaliers,2002,1,J. Lucas,lucasjo01c,29,53,82
Cleveland Cavaliers,CLE,Cleveland Cavaliers,2003,1,J. Lucas,lucasjo01c,8,34,42
Cleveland Cavaliers,CLE,Cleveland Cavaliers,2003,2,K. Smart,smartke01c,9,31,40
Cleveland Cavaliers,CLE,Cleveland Cavaliers,2004,1,P. Silas,silaspa01c,35,47,82
Cleveland Cavaliers,CLE,Cleveland Cavaliers,2005,1,P. Silas,silaspa01c,34,30,64
Cleveland Cavaliers,CLE,Cleveland Cavaliers,2005,2,B. Malone,malonbr99c,8,10,18
Cleveland Cavaliers,CLE,Cleveland Cavaliers,2006,1,M. Brown,brownmi99c,50,32,82
Cleveland Cavaliers,CLE,Cleveland Cavaliers,2007,1,M. Brown,brownmi99c,50,32,82
Cleveland Cavaliers,CLE,Cleveland Cavaliers,2008,1,M. Brown,brownmi99c,45,37,82
Cleveland Cavaliers,CLE,Cleveland Cavaliers,2009,1,M. Brown,brownmi99c,66,16,82
Cleveland Cavaliers,CLE,Cleveland Cavaliers,2010,1,M. Brown,brownmi99c,61,21,82
Cleveland Cavaliers,CLE,Cleveland Cavaliers,2011,1,B. Scott,scottby01c,19,63,82
Cleveland Cavaliers,CLE,Cleveland Cavaliers,2012,1,B. Scott,scottby01c,21,45,66
Cleveland Cavaliers,CLE,Cleveland Cavaliers,2013,1,B. Scott,scottby01c,24,58,82
Cleveland Cavaliers,CLE,Cleveland Cavaliers,2014,1,M. Brown,brownmi99c,33,49,82
Cleveland Cavaliers,CLE,Cleveland Cavaliers,2015,1,D. Blatt,blattda99c,53,29,82
Cleveland Cavaliers,CLE,Cleveland Cavaliers,2016,1,D. Blatt,blattda99c,30,11,41
Cleveland Cavaliers,CLE,Cleveland Cavaliers,2016,2,T. Lue,luety01c,27,14,41
Cleveland Cavaliers,CLE,Cleveland Cavaliers,2017,1,T. Lue,luety01c,51,31,82
Cleveland Cavaliers,CLE,Cleveland Cavaliers,2018,1,T. Lue,luety01c,50,32,82
Cleveland Cavaliers,CLE,Cleveland Cavaliers,2019,1,T. Lue,luety01c,0,6,6
Cleveland Cavaliers,CLE,Cleveland Cavaliers,2019,2,L. Drew,drewla01c,19,57,76
Cleveland Cavaliers,CLE,Cleveland Cavaliers,2020,1,J. Beilein,beilejo99c,14,40,54
Cleveland Cavaliers,CLE,Cleveland Cavaliers,2020,2,J. Bickerstaff,bickejb01c,5,6,11
Dallas Mavericks,DAL,Dallas Mavericks,1981,1,D. Motta,mottadi99c,15,67,82
Dallas Mavericks,DAL,Dallas Mavericks,1982,1,D. Motta,mottadi99c,28,54,82
Dallas Mavericks,DAL,Dallas Mavericks,1983,1,D. Motta,mottadi99c,38,44,82
Dallas Mavericks,DAL,Dallas Mavericks,1984,1,D. Motta,mottadi99c,43,39,82
Dallas Mavericks,DAL,Dallas Mavericks,1985,1,D. Motta,mottadi99c,44,38,82
Dallas Mavericks,DAL,Dallas Mavericks,1986,1,D. Motta,mottadi99c,44,38,82
Dallas Mavericks,DAL,Dallas Mavericks,1987,1,D. Motta,mottadi99c,55,27,82
Dallas Mavericks,DAL,Dallas Mavericks,1988,1,J. MacLeod,maclejo99c,53,29,82
Dallas Mavericks,DAL,Dallas Mavericks,1989,1,J. MacLeod,maclejo99c,38,44,82
Dallas Mavericks,DAL,Dallas Mavericks,1990,1,J. MacLeod,maclejo99c,5,6,11
Dallas Mavericks,DAL,Dallas Mavericks,1990,2,R. Adubato,adubari99c,42,29,71
Dallas Mavericks,DAL,Dallas Mavericks,1991,1,R. Adubato,adubari99c,28,54,82
Dallas Mavericks,DAL,Dallas Mavericks,1992,1,R. Adubato,adubari99c,22,60,82
Dallas Mavericks,DAL,Dallas Mavericks,1993,1,R. Adubato,adubari99c,2,27,29
Dallas Mavericks,DAL,Dallas Mavericks,1993,2,G. Heard,heardga01c,9,44,53
Dallas Mavericks,DAL,Dallas Mavericks,1994,1,Q. Buckner,bucknqu01c,13,69,82
Dallas Mavericks,DAL,Dallas Mavericks,1995,1,D. Motta,mottadi99c,36,46,82
Dallas Mavericks,DAL,Dallas Mavericks,1996,1,D. Motta,mottadi99c,26,56,82
Dallas Mavericks,DAL,Dallas Mavericks,1997,1,J. Cleamons,cleamji01c,24,58,82
Dallas Mavericks,DAL,Dallas Mavericks,1998,1,J. Cleamons,cleamji01c,4,12,16
Dallas Mavericks,DAL,Dallas Mavericks,1998,2,D. Nelson,nelsodo01c,16,50,66
Dallas Mavericks,DAL,Dallas Mavericks,1999,1,D. Nelson,nelsodo01c,19,31,50
Dallas Mavericks,DAL,Dallas Mavericks,2000,1,D. Nelson,nelsodo01c,40,42,82
Dallas Mavericks,DAL,Dallas Mavericks,2001,1,D. Nelson,nelsodo01c,53,29,82
Dallas Mavericks,DAL,Dallas Mavericks,2002,1,D. Nelson,nelsodo01c,57,25,82
Dallas Mavericks,DAL,Dallas Mavericks,2003,1,D. Nelson,nelsodo01c,60,22,82
Dallas Mavericks,DAL,Dallas Mavericks,2004,1,D. Nelson,nelsodo01c,52,30,82
Dallas Mavericks,DAL,Dallas Mavericks,2005,1,D. Nelson,nelsodo01c,42,22,64
Dallas Mavericks,DAL,Dallas Mavericks,2005,2,A. Johnson,johnsav01c,16,2,18
Dallas Mavericks,DAL,Dallas Mavericks,2006,1,A. Johnson,johnsav01c,60,22,82
Dallas Mavericks,DAL,Dallas Mavericks,2007,1,A. Johnson,johnsav01c,67,15,82
Dallas Mavericks,DAL,Dallas Mavericks,2008,1,A. Johnson,johnsav01c,51,31,82
Dallas Mavericks,DAL,Dallas Mavericks,2009,1,R. Carlisle,carliri01c,50,32,82
Dallas Mavericks,DAL,Dallas Mavericks,2010,1,R. Carlisle,carliri01c,55,27,82
Dallas Mavericks,DAL,Dallas Mavericks,2011,1,R. Carlisle,carliri01c,57,25,82
Dallas Mavericks,DAL,Dallas Mavericks,2012,1,R. Carlisle,carliri01c,36,30,66
Dallas Mavericks,DAL,Dallas Mavericks,2013,1,R. Carlisle,carliri01c,41,41,82
Dallas Mavericks,DAL,Dallas Mavericks,2014,1,R. Carlisle,carliri01c,49,33,82
Dallas Mavericks,DAL,Dallas Mavericks,2015,1,R. Carlisle,carliri01c,50,32,82
Dallas Mavericks,DAL,Dallas Mavericks,2016,1,R. Carlisle,carliri01c,42,40,82
Dallas Mavericks,DAL,Dallas Mavericks,2017,1,R. Carlisle,carliri01c,33,49,82
Dallas Mavericks,DAL,Dallas Mavericks,2018,1,R. Carlisle,carliri01c,24,58,82
Dallas Mavericks,DAL,Dallas Mavericks,2019,1,R. Carlisle,carliri01c,33,49,82
Dallas Mavericks,DAL,Dallas Mavericks,2020,1,R. Carlisle,carliri01c,40,27,67
Denver Nuggets,DEN,Denver Rockets,1968,1,B. Bass,bassbo99c,45,33,78
Denver Nuggets,DEN,Denver Rockets,1969,1,B. Bass,bassbo99c,44,34,78
Denver Nuggets,DEN,Denver Rockets,1970,1,J. McLendon,mclenjo99c,9,19,28
Denver Nuggets,DEN,Denver Rockets,1970,2,J. Belmont,belmojo99c,42,14,56
Denver Nuggets,DEN,Denver Rockets,1971,1,J. Belmont,belmojo99c,3,10,13
Denver Nuggets,DEN,Denver Rockets,1971,2,S. Albeck,albecst99c,27,44,71
Denver Nuggets,DEN,Denver Rockets,1972,1,A. Hannum,hannual01c,34,50,84
Denver Nuggets,DEN,Denver Rockets,1973,1,A. Hannum,hannual01c,47,37,84
Denver Nuggets,DEN,Denver Rockets,1974,1,A. Hannum,hannual01c,37,47,84
Denver Nuggets,DEN,Denver Nuggets,1975,1,L. Brown,brownla01c,65,19,84
Denver Nuggets,DEN,Denver Nuggets,1976,1,L. Brown,brownla01c,60,24,84
Denver Nuggets,DEN,Denver Nuggets,1977,1,L. Brown,brownla01c,50,32,82
Denver Nuggets,DEN,Denver Nuggets,1978,1,L. Brown,brownla01c,48,34,82
Denver Nuggets,DEN,Denver Nuggets,1979,1,L. Brown,brownla01c,28,25,53
Denver Nuggets,DEN,Denver Nuggets,1979,2,D. Walsh,walshdo99c,19,10,29
Denver Nuggets,DEN,Denver Nuggets,1980,1,D. Walsh,walshdo99c,30,52,82
Denver Nuggets,DEN,Denver Nuggets,1981,1,D. Walsh,walshdo99c,11,20,31
Denver Nuggets,DEN,Denver Nuggets,1981,2,D. Moe,moedo01c,26,25,51
Denver Nuggets,DEN,Denver Nuggets,1982,1,D. Moe,moedo01c,46,36,82
Denver Nuggets,DEN,Denver Nuggets,1983,1,D. Moe,moedo01c,45,37,82
Denver Nuggets,DEN,Denver Nuggets,1984,1,D. Moe,moedo01c,38,44,82
Denver Nuggets,DEN,Denver Nuggets,1985,1,D. Moe,moedo01c,52,30,82
Denver Nuggets,DEN,Denver Nuggets,1986,1,D. Moe,moedo01c,47,35,82
Denver Nuggets,DEN,Denver Nuggets,1987,1,D. Moe,moedo01c,37,45,82
Denver Nuggets,DEN,Denver Nuggets,1988,1,D. Moe,moedo01c,54,28,82
Denver Nuggets,DEN,Denver Nuggets,1989,1,D. Moe,moedo01c,44,38,82
Denver Nuggets,DEN,Denver Nuggets,1990,1,D. Moe,moedo01c,43,39,82
Denver Nuggets,DEN,Denver Nuggets,1991,1,P. Westhead,westhpa99c,20,62,82
Denver Nuggets,DEN,Denver Nuggets,1992,1,P. Westhead,westhpa99c,24,58,82
Denver Nuggets,DEN,Denver Nuggets,1993,1,D. Issel,isselda01c,36,46,82
Denver Nuggets,DEN,Denver Nuggets,1994,1,D. Issel,isselda01c,42,40,82
Denver Nuggets,DEN,Denver Nuggets,1995,1,D. Issel,isselda01c,18,16,34
Denver Nuggets,DEN,Denver Nuggets,1995,2,G. Littles,littlge01c,3,13,16
Denver Nuggets,DEN,Denver Nuggets,1995,3,B. Bickerstaff,bickebe99c,20,12,32
Denver Nuggets,DEN,Denver Nuggets,1996,1,B. Bickerstaff,bickebe99c,35,47,82
Denver Nuggets,DEN,Denver Nuggets,1997,1,B. Bickerstaff,bickebe99c,4,9,13
Denver Nuggets,DEN,Denver Nuggets,1997,2,D. Motta,mottadi99c,17,52,69
Denver Nuggets,DEN,Denver Nuggets,1998,1,B. Hanzlik,hanzlbi01c,11,71,82
Denver Nuggets,DEN,Denver Nuggets,1999,1,M. D'Antoni,dantomi01c,14,36,50
Denver Nuggets,DEN,Denver Nuggets,2000,1,D. Issel,isselda01c,35,47,82
Denver Nuggets,DEN,Denver Nuggets,2001,1,D. Issel,isselda01c,40,42,82
Denver Nuggets,DEN,Denver Nuggets,2002,1,D. Issel,isselda01c,9,17,26
Denver Nuggets,DEN,Denver Nuggets,2002,2,M. Evans,evansmi01c,18,38,56
Denver Nuggets,DEN,Denver Nuggets,2003,1,J. Bzdelik,bzdelje99c,17,65,82
Denver Nuggets,DEN,Denver Nuggets,2004,1,J. Bzdelik,bzdelje99c,43,39,82
Denver Nuggets,DEN,Denver Nuggets,2005,1,J. Bzdelik,bzdelje99c,13,15,28
Denver Nuggets,DEN,Denver Nuggets,2005,2,M. Cooper,coopemi01c,4,10,14
Denver Nuggets,DEN,Denver Nuggets,2005,3,G. Karl,karlge01c,32,8,40
Denver Nuggets,DEN,Denver Nuggets,2006,1,G. Karl,karlge01c,44,38,82
Denver Nuggets,DEN,Denver Nuggets,2007,1,G. Karl,karlge01c,45,37,82
Denver Nuggets,DEN,Denver Nuggets,2008,1,G. Karl,karlge01c,50,32,82
Denver Nuggets,DEN,Denver Nuggets,2009,1,G. Karl,karlge01c,54,28,82
Denver Nuggets,DEN,Denver Nuggets,2010,1,G. Karl,karlge01c,53,29,82
Denver Nuggets,DEN,Denver Nuggets,2011,1,G. Karl,karlge01c,50,32,82
Denver Nuggets,DEN,Denver Nuggets,2012,1,G. Karl,karlge01c,38,28,66
Denver Nuggets,DEN,Denver Nuggets,2013,1,G. Karl,karlge01c,57,25,82
Denver Nuggets,DEN,Denver Nuggets,2014,1,B. Shaw,shawbr01c,36,46,82
Denver Nuggets,DEN,Denver Nuggets,2015,1,B. Shaw,shawbr01c,20,39,59
Denver Nuggets,DEN,Denver Nuggets,2015,2,M. Hunt,huntme01c,10,13,23
Denver Nuggets,DEN,Denver Nuggets,2016,1,M. Malone,malonmi99c,33,49,82
Denver Nuggets,DEN,Denver Nuggets,2017,1,M. Malone,malonmi99c,40,42,82
Denver Nuggets,DEN,Denver Nuggets,2018,1,M. Malone,malonmi99c,46,36,82
Denver Nuggets,DEN,Denver Nuggets,2019,1,M. Malone,malonmi99c,54,28,82
Denver Nuggets,DEN,Denver Nuggets,2020,1,M. Malone,malonmi99c,43,22,65
Detroit Pistons,DET,Fort Wayne Pistons,1949,1,C. Bennett,benneca99c,0,6,6
Detroit Pistons,DET,Fort Wayne Pistons,1949,2,C. Armstrong,armstcu01c,22,32,54
Detroit Pistons,DET,Fort Wayne Pistons,1950,1,M. Mendenhall,mendemu99c,40,28,68
Detroit Pistons,DET,Fort Wayne Pistons,1951,1,M. Mendenhall,mendemu99c,32,36,68
Detroit Pistons,DET,Fort Wayne Pistons,1952,1,P. Birch,birchpa99c,29,37,66
Detroit Pistons,DET,Fort Wayne Pistons,1953,1,P. Birch,birchpa99c,36,33,69
Detroit Pistons,DET,Fort Wayne Pistons,1954,1,P. Birch,birchpa99c,40,32,72
Detroit Pistons,DET,Fort Wayne Pistons,1955,1,C. Eckman,eckmach99c,43,29,72
Detroit Pistons,DET,Fort Wayne Pistons,1956,1,C. Eckman,eckmach99c,37,35,72
Detroit Pistons,DET,Fort Wayne Pistons,1957,1,C. Eckman,eckmach99c,34,38,72
Detroit Pistons,DET,Detroit Pistons,1958,1,C. Eckman,eckmach99c,9,16,25
Detroit Pistons,DET,Detroit Pistons,1958,2,R. Rocha,rochare01c,24,23,47
Detroit Pistons,DET,Detroit Pistons,1959,1,R. Rocha,rochare01c,28,44,72
Detroit Pistons,DET,Detroit Pistons,1960,1,R. Rocha,rochare01c,13,21,34
Detroit Pistons,DET,Detroit Pistons,1960,2,D. McGuire,mcguidi01c,17,24,41
Detroit Pistons,DET,Detroit Pistons,1961,1,D. McGuire,mcguidi01c,34,45,79
Detroit Pistons,DET,Detroit Pistons,1962,1,D. McGuire,mcguidi01c,37,43,80
Detroit Pistons,DET,Detroit Pistons,1963,1,D. McGuire,mcguidi01c,34,46,80
Detroit Pistons,DET,Detroit Pistons,1964,1,C. Wolf,wolfch99c,23,57,80
Detroit Pistons,DET,Detroit Pistons,1965,1,C. Wolf,wolfch99c,2,9,11
Detroit Pistons,DET,Detroit Pistons,1965,2,D. DeBusschere,debusda01c,29,40,69
Detroit Pistons,DET,Detroit Pistons,1966,1,D. DeBusschere,debusda01c,22,58,80
Detroit Pistons,DET,Detroit Pistons,1967,1,D. DeBusschere,debusda01c,28,45,73
Detroit Pistons,DET,Detroit Pistons,1967,2,D. Butcher,butchdo01c,2,6,8
Detroit Pistons,DET,Detroit Pistons,1968,1,D. Butcher,butchdo01c,40,42,82
Detroit Pistons,DET,Detroit Pistons,1969,1,D. Butcher,butchdo01c,10,12,22
Detroit Pistons,DET,Detroit Pistons,1969,2,P. Seymour,seymopa01c,22,38,60
Detroit Pistons,DET,Detroit Pistons,1970,1,B. van Breda Kolff,vanbrbu01c,31,51,82
Detroit Pistons,DET,Detroit Pistons,1971,1,B. van Breda Kolff,vanbrbu01c,45,37,82
Detroit Pistons,DET,Detroit Pistons,1972,1,B. van Breda Kolff,vanbrbu01c,6,4,10
Detroit Pistons,DET,Detroit Pistons,1972,2,T. Dischinger,dischte01c,0,2,2
Detroit Pistons,DET,Detroit Pistons,1972,3,E. Lloyd,lloydea01c,20,50,70
Detroit Pistons,DET,Detroit Pistons,1973,1,E. Lloyd,lloydea01c,2,5,7
Detroit Pistons,DET,Detroit Pistons,1973,2,R. Scott,scottra01c,38,37,75
Detroit Pistons,DET,Detroit Pistons,1974,1,R. Scott,scottra01c,52,30,82
Detroit Pistons,DET,Detroit Pistons,1975,1,R. Scott,scottra01c,40,42,82
Detroit Pistons,DET,Detroit Pistons,1976,1,R. Scott,scottra01c,17,25,42
Detroit Pistons,DET,Detroit Pistons,1976,2,H. Brown,brownhe99c,19,21,40
Detroit Pistons,DET,Detroit Pistons,1977,1,H. Brown,brownhe99c,44,38,82
Detroit Pistons,DET,Detroit Pistons,1978,1,H. Brown,brownhe99c,9,15,24
Detroit Pistons,DET,Detroit Pistons,1978,2,B. Kauffman,kauffbo01c,29,29,58
Detroit Pistons,DET,Detroit Pistons,1979,1,D. Vitale,vitaldi99c,30,52,82
Detroit Pistons,DET,Detroit Pistons,1980,1,D. Vitale,vitaldi99c,4,8,12
Detroit Pistons,DET,Detroit Pistons,1980,2,R. Adubato,adubari99c,12,58,70
Detroit Pistons,DET,Detroit Pistons,1981,1,S. Robertson,robersc99c,21,61,82
Detroit Pistons,DET,Detroit Pistons,1982,1,S. Robertson,robersc99c,39,43,82
Detroit Pistons,DET,Detroit Pistons,1983,1,S. Robertson,robersc99c,37,45,82
Detroit Pistons,DET,Detroit Pistons,1984,1,C. Daly,dalych99c,49,33,82
Detroit Pistons,DET,Detroit Pistons,1985,1,C. Daly,dalych99c,46,36,82
Detroit Pistons,DET,Detroit Pistons,1986,1,C. Daly,dalych99c,46,36,82
Detroit Pistons,DET,Detroit Pistons,1987,1,C. Daly,dalych99c,52,30,82
Detroit Pistons,DET,Detroit Pistons,1988,1,C. Daly,dalych99c,54,28,82
Detroit Pistons,DET,Detroit Pistons,1989,1,C. Daly,dalych99c,63,19,82
Detroit Pistons,DET,Detroit Pistons,1990,1,C. Daly,dalych99c,59,23,82
Detroit Pistons,DET,Detroit Pistons,1991,1,C. Daly,dalych99c,50,32,82
Detroit Pistons,DET,Detroit Pistons,1992,1,C. Daly,dalych99c,48,34,82
Detroit Pistons,DET,Detroit Pistons,1993,1,R. Rothstein,rothsro99c,40,42,82
Detroit Pistons,DET,Detroit Pistons,1994,1,D. Chaney,chanedo01c,20,62,82
Detroit Pistons,DET,Detroit Pistons,1995,1,D. Chaney,chanedo01c,28,54,82
Detroit Pistons,DET,Detroit Pistons,1996,1,D. Collins,collido01c,46,36,82
Detroit Pistons,DET,Detroit Pistons,1997,1,D. Collins,collido01c,54,28,82
Detroit Pistons,DET,Detroit Pistons,1998,1,D. Collins,collido01c,21,24,45
Detroit Pistons,DET,Detroit Pistons,1998,2,A. Gentry,gentral99c,16,21,37
Detroit Pistons,DET,Detroit Pistons,1999,1,A. Gentry,gentral99c,29,21,50
Detroit Pistons,DET,Detroit Pistons,2000,1,A. Gentry,gentral99c,28,30,58
Detroit Pistons,DET,Detroit Pistons,2000,2,G. Irvine,irvinge01c,14,10,24
Detroit Pistons,DET,Detroit Pistons,2001,1,G. Irvine,irvinge01c,32,50,82
Detroit Pistons,DET,Detroit Pistons,2002,1,R. Carlisle,carliri01c,50,32,82
Detroit Pistons,DET,Detroit Pistons,2003,1,R. Carlisle,carliri01c,50,32,82
Detroit Pistons,DET,Detroit Pistons,2004,1,L. Brown,brownla01c,54,28,82
Detroit Pistons,DET,Detroit Pistons,2005,1,L. Brown,brownla01c,54,28,82
Detroit Pistons,DET,Detroit Pistons,2006,1,F. Saunders,saundfl99c,64,18,82
Detroit Pistons,DET,Detroit Pistons,2007,1,F. Saunders,saundfl99c,53,29,82
Detroit Pistons,DET,Detroit Pistons,2008,1,F. Saunders,saundfl99c,59,23,82
Detroit Pistons,DET,Detroit Pistons,2009,1,M. Curry,currymi01c,39,43,82
Detroit Pistons,DET,Detroit Pistons,2010,1,J. Kuester,kuestjo01c,27,55,82
Detroit Pistons,DET,Detroit Pistons,2011,1,J. Kuester,kuestjo01c,30,52,82
Detroit Pistons,DET,Detroit Pistons,2012,1,L. Frank,frankla99c,25,41,66
Detroit Pistons,DET,Detroit Pistons,2013,1,L. Frank,frankla99c,29,53,82
Detroit Pistons,DET,Detroit Pistons,2014,1,M. Cheeks,cheekma01c,21,29,50
Detroit Pistons,DET,Detroit Pistons,2014,2,J. Loyer,loyerjo99c,8,24,32
Detroit Pistons,DET,Detroit Pistons,2015,1,S. Van Gundy,vangust99c,32,50,82
Detroit Pistons,DET,Detroit Pistons,2016,1,S. Van Gundy,vangust99c,44,38,82
Detroit Pistons,DET,Detroit Pistons,2017,1,S. Van Gundy,vangust99c,37,45,82
Detroit Pistons,DET,Detroit Pistons,2018,1,S. Van Gundy,vangust99c,39,43,82
Detroit Pistons,DET,Detroit Pistons,2019,1,D. Casey,caseydw99c,41,41,82
Detroit Pistons,DET,Detroit Pistons,2020,1,D. Casey,caseydw99c,20,46,66
Golden State Warriors,GSW,Philadelphia Warriors,1947,1,E. Gottlieb,gottled99c,35,25,60
Golden State Warriors,GSW,Philadelphia Warriors,1948,1,E. Gottlieb,gottled99c,27,21,48
Golden State Warriors,GSW,Philadelphia Warriors,1949,1,E. Gottlieb,gottled99c,28,32,60
Golden State Warriors,GSW,Philadelphia Warriors,1950,1,E. Gottlieb,gottled99c,26,42,68
Golden State Warriors,GSW,Philadelphia Warriors,1951,1,E. Gottlieb,gottled99c,40,26,66
Golden State Warriors,GSW,Philadelphia Warriors,1952,1,E. Gottlieb,gottled99c,33,33,66
Golden State Warriors,GSW,Philadelphia Warriors,1953,1,E. Gottlieb,gottled99c,12,57,69
Golden State Warriors,GSW,Philadelphia Warriors,1954,1,E. Gottlieb,gottled99c,29,43,72
Golden State Warriors,GSW,Philadelphia Warriors,1955,1,E. Gottlieb,gottled99c,33,39,72
Golden State Warriors,GSW,Philadelphia Warriors,1956,1,G. Senesky,senesge01c,45,27,72
Golden State Warriors,GSW,Philadelphia Warriors,1957,1,G. Senesky,senesge01c,37,35,72
Golden State Warriors,GSW,Philadelphia Warriors,1958,1,G. Senesky,senesge01c,37,35,72
Golden State Warriors,GSW,Philadelphia Warriors,1959,1,A. Cervi,cervial01c,32,40,72
Golden State Warriors,GSW,Philadelphia Warriors,1960,1,N. Johnston,johnsne01c,49,26,75
Golden State Warriors,GSW,Philadelphia Warriors,1961,1,N. Johnston,johnsne01c,46,33,79
Golden State Warriors,GSW,Philadelphia Warriors,1962,1,F. McGuire,mcguifr99c,49,31,80
Golden State Warriors,GSW,San Francisco Warriors,1963,1,B. Feerick,feeribo01c,31,49,80
Golden State Warriors,GSW,San Francisco Warriors,1964,1,A. Hannum,hannual01c,48,32,80
Golden State Warriors,GSW,San Francisco Warriors,1965,1,A. Hannum,hannual01c,17,63,80
Golden State Warriors,GSW,San Francisco Warriors,1966,1,A. Hannum,hannual01c,35,45,80
Golden State Warriors,GSW,San Francisco Warriors,1967,1,B. Sharman,sharmbi01c,44,37,81
Golden State Warriors,GSW,San Francisco Warriors,1968,1,B. Sharman,sharmbi01c,43,39,82
Golden State Warriors,GSW,San Francisco Warriors,1969,1,G. Lee,leege01c,41,41,82
Golden State Warriors,GSW,San Francisco Warriors,1970,1,G. Lee,leege01c,22,30,52
Golden State Warriors,GSW,San Francisco Warriors,1970,2,A. Attles,attleal01c,8,22,30
Golden State Warriors,GSW,San Francisco Warriors,1971,1,A. Attles,attleal01c,41,41,82
Golden State Warriors,GSW,Golden State Warriors,1972,1,A. Attles,attleal01c,51,31,82
Golden State Warriors,GSW,Golden State Warriors,1973,1,A. Attles,attleal01c,47,35,82
Golden State Warriors,GSW,Golden State Warriors,1974,1,A. Attles,attleal01c,44,38,82
Golden State Warriors,GSW,Golden State Warriors,1975,1,A. Attles,attleal01c,48,34,82
Golden State Warriors,GSW,Golden State Warriors,1976,1,A. Attles,attleal01c,59,23,82
Golden State Warriors,GSW,Golden State Warriors,1977,1,A. Attles,attleal01c,46,36,82
Golden State Warriors,GSW,Golden State Warriors,1978,1,A. Attles,attleal01c,43,39,82
Golden State Warriors,GSW,Golden State Warriors,1979,1,A. Attles,attleal01c,38,44,82
Golden State Warriors,GSW,Golden State Warriors,1980,1,A. Attles,attleal01c,18,43,61
Golden State Warriors,GSW,Golden State Warriors,1980,2,J. Bach,bachjo01c,6,15,21
Golden State Warriors,GSW,Golden State Warriors,1981,1,A. Attles,attleal01c,39,43,82
Golden State Warriors,GSW,Golden State Warriors,1982,1,A. Attles,attleal01c,45,37,82
Golden State Warriors,GSW,Golden State Warriors,1983,1,A. Attles,attleal01c,30,52,82
Golden State Warriors,GSW,Golden State Warriors,1984,1,J. Bach,bachjo01c,37,45,82
Golden State Warriors,GSW,Golden State Warriors,1985,1,J. Bach,bachjo01c,22,60,82
Golden State Warriors,GSW,Golden State Warriors,1986,1,J. Bach,bachjo01c,30,52,82
Golden State Warriors,GSW,Golden State Warriors,1987,1,G. Karl,karlge01c,42,40,82
Golden State Warriors,GSW,Golden State Warriors,1988,1,G. Karl,karlge01c,16,48,64
Golden State Warriors,GSW,Golden State Warriors,1988,2,E. Gregory,gregoed99c,4,14,18
Golden State Warriors,GSW,Golden State Warriors,1989,1,D. Nelson,nelsodo01c,43,39,82
Golden State Warriors,GSW,Golden State Warriors,1990,1,D. Nelson,nelsodo01c,37,45,82
Golden State Warriors,GSW,Golden State Warriors,1991,1,D. Nelson,nelsodo01c,44,38,82
Golden State Warriors,GSW,Golden State Warriors,1992,1,D. Nelson,nelsodo01c,55,27,82
Golden State Warriors,GSW,Golden State Warriors,1993,1,D. Nelson,nelsodo01c,34,48,82
Golden State Warriors,GSW,Golden State Warriors,1994,1,D. Nelson,nelsodo01c,50,32,82
Golden State Warriors,GSW,Golden State Warriors,1995,1,D. Nelson,nelsodo01c,14,31,45
Golden State Warriors,GSW,Golden State Warriors,1995,2,B. Lanier,laniebo01c,12,25,37
Golden State Warriors,GSW,Golden State Warriors,1996,1,R. Adelman,adelmri01c,36,46,82
Golden State Warriors,GSW,Golden State Warriors,1997,1,R. Adelman,adelmri01c,30,52,82
Golden State Warriors,GSW,Golden State Warriors,1998,1,P. Carlesimo,carlepj99c,19,63,82
Golden State Warriors,GSW,Golden State Warriors,1999,1,P. Carlesimo,carlepj99c,21,29,50
Golden State Warriors,GSW,Golden State Warriors,2000,1,P. Carlesimo,carlepj99c,6,21,27
Golden State Warriors,GSW,Golden State Warriors,2000,2,G. St. Jean,stjeaga99c,13,42,55
Golden State Warriors,GSW,Golden State Warriors,2001,1,D. Cowens,cowenda01c,17,65,82
Golden State Warriors,GSW,Golden State Warriors,2002,1,D. Cowens,cowenda01c,8,15,23
Golden State Warriors,GSW,Golden State Warriors,2002,2,B. Winters,wintebr01c,13,46,59
Golden State Warriors,GSW,Golden State Warriors,2003,1,E. Musselman,musseer99c,38,44,82
Golden State Warriors,GSW,Golden State Warriors,2004,1,E. Musselman,musseer99c,37,45,82
Golden State Warriors,GSW,Golden State Warriors,2005,1,M. Montgomery,montgmi99c,34,48,82
Golden State Warriors,GSW,Golden State Warriors,2006,1,M. Montgomery,montgmi99c,34,48,82
Golden State Warriors,GSW,Golden State Warriors,2007,1,D. Nelson,nelsodo01c,42,40,82
Golden State Warriors,GSW,Golden State Warriors,2008,1,D. Nelson,nelsodo01c,48,34,82
Golden State Warriors,GSW,Golden State Warriors,2009,1,D. Nelson,nelsodo01c,29,53,82
Golden State Warriors,GSW,Golden State Warriors,2010,1,D. Nelson,nelsodo01c,26,56,82
Golden State Warriors,GSW,Golden State Warriors,2011,1,K. Smart,smartke01c,36,46,82
Golden State Warriors,GSW,Golden State Warriors,2012,1,M. Jackson,jacksma01c,23,43,66
Golden State Warriors,GSW,Golden State Warriors,2013,1,M. Jackson,jacksma01c,47,35,82
Golden State Warriors,GSW,Golden State Warriors,2014,1,M. Jackson,jacksma01c,51,31,82
Golden State Warriors,GSW,Golden State Warriors,2015,1,S. Kerr,kerrst01c,67,15,82
Golden State Warriors,GSW,Golden State Warriors,2016,1,S. Kerr,kerrst01c,73,9,82
Golden State Warriors,GSW,Golden State Warriors,2017,1,S. Kerr,kerrst01c,67,15,82
Golden State Warriors,GSW,Golden State Warriors,2018,1,S. Kerr,kerrst01c,58,24,82
Golden State Warriors,GSW,Golden State Warriors,2019,1,S. Kerr,kerrst01c,57,25,82
Golden State Warriors,GSW,Golden State Warriors,2020,1,S. Kerr,kerrst01c,15,50,65
Houston Rockets,HOU,San Diego Rockets,1968,1,J. McMahon,mcmahja01c,15,67,82
Houston Rockets,HOU,San Diego Rockets,1969,1,J. McMahon,mcmahja01c,37,45,82
Houston Rockets,HOU,San Diego Rockets,1970,1,J. McMahon,mcmahja01c,9,17,26
Houston Rockets,HOU,San Diego Rockets,1970,2,A. Hannum,hannual01c,18,38,56
Houston Rockets,HOU,San Diego Rockets,1971,1,A. Hannum,hannual01c,40,42,82
Houston Rockets,HOU,Houston Rockets,1972,1,T. Winter,wintete99c,34,48,82
Houston Rockets,HOU,Houston Rockets,1973,1,T. Winter,wintete99c,17,30,47
Houston Rockets,HOU,Houston Rockets,1973,2,J. Egan,eganjo01c,16,19,35
Houston Rockets,HOU,Houston Rockets,1974,1,J. Egan,eganjo01c,32,50,82
Houston Rockets,HOU,Houston Rockets,1975,1,J. Egan,eganjo01c,41,41,82
Houston Rockets,HOU,Houston Rockets,1976,1,J. Egan,eganjo01c,40,42,82
Houston Rockets,HOU,Houston Rockets,1977,1,T. Nissalke,nissato99c,49,33,82
Houston Rockets,HOU,Houston Rockets,1978,1,T. Nissalke,nissato99c,28,54,82
Houston Rockets,HOU,Houston Rockets,1979,1,T. Nissalke,nissato99c,47,35,82
Houston Rockets,HOU,Houston Rockets,1980,1,D. Harris,harride99c,41,41,82
Houston Rockets,HOU,Houston Rockets,1981,1,D. Harris,harride99c,40,42,82
Houston Rockets,HOU,Houston Rockets,1982,1,D. Harris,harride99c,46,36,82
Houston Rockets,HOU,Houston Rockets,1983,1,D. Harris,harride99c,14,68,82
Houston Rockets,HOU,Houston Rockets,1984,1,B. Fitch,fitchbi99c,29,53,82
Houston Rockets,HOU,Houston Rockets,1985,1,B. Fitch,fitchbi99c,48,34,82
Houston Rockets,HOU,Houston Rockets,1986,1,B. Fitch,fitchbi99c,51,31,82
Houston Rockets,HOU,Houston Rockets,1987,1,B. Fitch,fitchbi99c,42,40,82
Houston Rockets,HOU,Houston Rockets,1988,1,B. Fitch,fitchbi99c,46,36,82
Houston Rockets,HOU,Houston Rockets,1989,1,D. Chaney,chanedo01c,45,37,82
Houston Rockets,HOU,Houston Rockets,1990,1,D. Chaney,chanedo01c,41,41,82
Houston Rockets,HOU,Houston Rockets,1991,1,D. Chaney,chanedo01c,52,30,82
Houston Rockets,HOU,Houston Rockets,1992,1,D. Chaney,chanedo01c,26,26,52
Houston Rockets,HOU,Houston Rockets,1992,2,R. Tomjanovich,tomjaru01c,16,14,30
Houston Rockets,HOU,Houston Rockets,1993,1,R. Tomjanovich,tomjaru01c,55,27,82
Houston Rockets,HOU,Houston Rockets,1994,1,R. Tomjanovich,tomjaru01c,58,24,82
Houston Rockets,HOU,Houston Rockets,1995,1,R. Tomjanovich,tomjaru01c,47,35,82
Houston Rockets,HOU,Houston Rockets,1996,1,R. Tomjanovich,tomjaru01c,48,34,82
Houston Rockets,HOU,Houston Rockets,1997,1,R. Tomjanovich,tomjaru01c,57,25,82
Houston Rockets,HOU,Houston Rockets,1998,1,R. Tomjanovich,tomjaru01c,41,41,82
Houston Rockets,HOU,Houston Rockets,1999,1,R. Tomjanovich,tomjaru01c,31,19,50
Houston Rockets,HOU,Houston Rockets,2000,1,R. Tomjanovich,tomjaru01c,34,48,82
Houston Rockets,HOU,Houston Rockets,2001,1,R. Tomjanovich,tomjaru01c,45,37,82
Houston Rockets,HOU,Houston Rockets,2002,1,R. Tomjanovich,tomjaru01c,28,54,82
Houston Rockets,HOU,Houston Rockets,2003,1,R. Tomjanovich,tomjaru01c,43,39,82
Houston Rockets,HOU,Houston Rockets,2004,1,J. Van Gundy,vanguje99c,45,37,82
Houston Rockets,HOU,Houston Rockets,2005,1,J. Van Gundy,vanguje99c,51,31,82
Houston Rockets,HOU,Houston Rockets,2006,1,J. Van Gundy,vanguje99c,34,48,82
Houston Rockets,HOU,Houston Rockets,2007,1,J. Van Gundy,vanguje99c,52,30,82
Houston Rockets,HOU,Houston Rockets,2008,1,R. Adelman,adelmri01c,55,27,82
Houston Rockets,HOU,Houston Rockets,2009,1,R. Adelman,adelmri01c,53,29,82
Houston Rockets,HOU,Houston Rockets,2010,1,R. Adelman,adelmri01c,42,40,82
Houston Rockets,HOU,Houston Rockets,2011,1,R. Adelman,adelmri01c,43,39,82
Houston Rockets,HOU,Houston Rockets,2012,1,K. McHale,mchalke01c,34,32,66
Houston Rockets,HOU,Houston Rockets,2013,1,K. McHale,mchalke01c,45,37,82
Houston Rockets,HOU,Houston Rockets,2014,1,K. McHale,mchalke01c,54,28,82
Houston Rockets,HOU,Houston Rockets,2015,1,K. McHale,mchalke01c,56,26,82
Houston Rockets,HOU,Houston Rockets,2016,1,K. McHale,mchalke01c,4,7,11
Houston Rockets,HOU,Houston Rockets,2016,2,J. Bickerstaff,bickejb01c,37,34,71
Houston Rockets,HOU,Houston Rockets,2017,1,M. D'Antoni,dantomi01c,55,27,82
Houston Rockets,HOU,Houston Rockets,2018,1,M. D'Antoni,dantomi01c,65,17,82
Houston Rockets,HOU,Houston Rockets,2019,1,M. D'Antoni,dantomi01c,53,29,82
Houston Rockets,HOU,Houston Rockets,2020,1,M. D'Antoni,dantomi01c,40,24,64
Indiana Pacers,IND,Indiana Pacers,1968,1,L. Staverman,stavela01c,38,40,78
Indiana Pacers,IND,Indiana Pacers,1969,1,L. Staverman,stavela01c,2,7,9
Indiana Pacers,IND,Indiana Pacers,1969,2,S. Leonard,leonasl01c,42,27,69
Indiana Pacers,IND,Indiana Pacers,1970,1,S. Leonard,leonasl01c,59,25,84
Indiana Pacers,IND,Indiana Pacers,1971,1,S. Leonard,leonasl01c,58,26,84
Indiana Pacers,IND,Indiana Pacers,1972,1,S. Leonard,leonasl01c,47,37,84
Indiana Pacers,IND,Indiana Pacers,1973,1,S. Leonard,leonasl01c,51,33,84
Indiana Pacers,IND,Indiana Pacers,1974,1,S. Leonard,leonasl01c,46,38,84
Indiana Pacers,IND,Indiana Pacers,1975,1,S. Leonard,leonasl01c,45,39,84
Indiana Pacers,IND,Indiana Pacers,1976,1,S. Leonard,leonasl01c,39,45,84
Indiana Pacers,IND,Indiana Pacers,1977,1,S. Leonard,leonasl01c,36,46,82
Indiana Pacers,IND,Indiana Pacers,1978,1,S. Leonard,leonasl01c,31,51,82
Indiana Pacers,IND,Indiana Pacers,1979,1,S. Leonard,leonasl01c,38,44,82
Indiana Pacers,IND,Indiana Pacers,1980,1,S. Leonard,leonasl01c,37,45,82
Indiana Pacers,IND,Indiana Pacers,1981,1,J. McKinney,mckinja99c,44,38,82
Indiana Pacers,IND,Indiana Pacers,1982,1,J. McKinney,mckinja99c,35,47,82
Indiana Pacers,IND,Indiana Pacers,1983,1,J. McKinney,mckinja99c,20,62,82
Indiana Pacers,IND,Indiana Pacers,1984,1,J. McKinney,mckinja99c,26,56,82
Indiana Pacers,IND,Indiana Pacers,1985,1,G. Irvine,irvinge01c,22,60,82
Indiana Pacers,IND,Indiana Pacers,1986,1,G. Irvine,irvinge01c,26,56,82
Indiana Pacers,IND,Indiana Pacers,1987,1,J. Ramsay,ramsaja99c,41,41,82
Indiana Pacers,IND,Indiana Pacers,1988,1,J. Ramsay,ramsaja99c,38,44,82
Indiana Pacers,IND,Indiana Pacers,1989,1,J. Ramsay,ramsaja99c,0,7,7
Indiana Pacers,IND,Indiana Pacers,1989,2,M. Daniels,danieme01c,0,2,2
Indiana Pacers,IND,Indiana Pacers,1989,3,G. Irvine,irvinge01c,6,14,20
Indiana Pacers,IND,Indiana Pacers,1989,4,D. Versace,versadi99c,22,31,53
Indiana Pacers,IND,Indiana Pacers,1990,1,D. Versace,versadi99c,42,40,82
Indiana Pacers,IND,Indiana Pacers,1991,1,D. Versace,versadi99c,9,16,25
Indiana Pacers,IND,Indiana Pacers,1991,2,B. Hill,hillbo99c,32,25,57
Indiana Pacers,IND,Indiana Pacers,1992,1,B. Hill,hillbo99c,40,42,82
Indiana Pacers,IND,Indiana Pacers,1993,1,B. Hill,hillbo99c,41,41,82
Indiana Pacers,IND,Indiana Pacers,1994,1,L. Brown,brownla01c,47,35,82
Indiana Pacers,IND,Indiana Pacers,1995,1,L. Brown,brownla01c,52,30,82
Indiana Pacers,IND,Indiana Pacers,1996,1,L. Brown,brownla01c,52,30,82
Indiana Pacers,IND,Indiana Pacers,1997,1,L. Brown,brownla01c,39,43,82
Indiana Pacers,IND,Indiana Pacers,1998,1,L. Bird,birdla01c,58,24,82
Indiana Pacers,IND,Indiana Pacers,1999,1,L. Bird,birdla01c,33,17,50
Indiana Pacers,IND,Indiana Pacers,2000,1,L. Bird,birdla01c,56,26,82
Indiana Pacers,IND,Indiana Pacers,2001,1,I. Thomas,thomais01c,41,41,82
Indiana Pacers,IND,Indiana Pacers,2002,1,I. Thomas,thomais01c,42,40,82
Indiana Pacers,IND,Indiana Pacers,2003,1,I. Thomas,thomais01c,48,34,82
Indiana Pacers,IND,Indiana Pacers,2004,1,R. Carlisle,carliri01c,61,21,82
Indiana Pacers,IND,Indiana Pacers,2005,1,R. Carlisle,carliri01c,44,38,82
Indiana Pacers,IND,Indiana Pacers,2006,1,R. Carlisle,carliri01c,41,41,82
Indiana Pacers,IND,Indiana Pacers,2007,1,R. Carlisle,carliri01c,35,47,82
Indiana Pacers,IND,Indiana Pacers,2008,1,J. O'Brien,obrieji99c,36,46,82
Indiana Pacers,IND,Indiana Pacers,2009,1,J. O'Brien,obrieji99c,36,46,82
Indiana Pacers,IND,Indiana Pacers,2010,1,J. O'Brien,obrieji99c,32,50,82
Indiana Pacers,IND,Indiana Pacers,2011,1,J. O'Brien,obrieji99c,17,27,44
Indiana Pacers,IND,Indiana Pacers,2011,2,F. Vogel,vogelfr99c,20,18,38
Indiana Pacers,IND,Indiana Pacers,2012,1,F. Vogel,vogelfr99c,42,24,66
Indiana Pacers,IND,Indiana Pacers,2013,1,F. Vogel,vogelfr99c,49,32,81
Indiana Pacers,IND,Indiana Pacers,2014,1,F. Vogel,vogelfr99c,56,26,82
Indiana Pacers,IND,Indiana Pacers,2015,1,F. Vogel,vogelfr99c,38,44,82
Indiana Pacers,IND,Indiana Pacers,2016,1,F. Vogel,vogelfr99c,45,37,82
Indiana Pacers,IND,Indiana Pacers,2017,1,N. McMillan,mcmilna01c,42,40,82
Indiana Pacers,IND,Indiana Pacers,2018,1,N. McMillan,mcmilna01c,48,34,82
Indiana Pacers,IND,Indiana Pacers,2019,1,N. McMillan,mcmilna01c,48,34,82
Indiana Pacers,IND,Indiana Pacers,2020,1,N. McMillan,mcmilna01c,39,26,65
Los Angeles Clippers,LAC,Buffalo Braves,1971,1,D. Schayes,schaydo01c,22,60,82
Los Angeles Clippers,LAC,Buffalo Braves,1972,1,D. Schayes,schaydo01c,0,1,1
Los Angeles Clippers,LAC,Buffalo Braves,1972,2,J. McCarthy,mccarjo01c,22,59,81
Los Angeles Clippers,LAC,Buffalo Braves,1973,1,J. Ramsay,ramsaja99c,21,61,82
Los Angeles Clippers,LAC,Buffalo Braves,1974,1,J. Ramsay,ramsaja99c,42,40,82
Los Angeles Clippers,LAC,Buffalo Braves,1975,1,J. Ramsay,ramsaja99c,49,33,82
Los Angeles Clippers,LAC,Buffalo Braves,1976,1,J. Ramsay,ramsaja99c,46,36,82
Los Angeles Clippers,LAC,Buffalo Braves,1977,1,T. Locke,locketa99c,16,30,46
Los Angeles Clippers,LAC,Buffalo Braves,1977,2,B. MacKinnon,mackibo99c,3,4,7
Los Angeles Clippers,LAC,Buffalo Braves,1977,3,J. Mullaney,mullajo01c,11,18,29
Los Angeles Clippers,LAC,Buffalo Braves,1978,1,C. Fitzsimmons,fitzsco99c,27,55,82
Los Angeles Clippers,LAC,San Diego Clippers,1979,1,G. Shue,shuege01c,43,39,82
Los Angeles Clippers,LAC,San Diego Clippers,1980,1,G. Shue,shuege01c,35,47,82
Los Angeles Clippers,LAC,San Diego Clippers,1981,1,P. Silas,silaspa01c,36,46,82
Los Angeles Clippers,LAC,San Diego Clippers,1982,1,P. Silas,silaspa01c,17,65,82
Los Angeles Clippers,LAC,San Diego Clippers,1983,1,P. Silas,silaspa01c,25,57,82
Los Angeles Clippers,LAC,San Diego Clippers,1984,1,J. Lynam,lynamji99c,30,52,82
Los Angeles Clippers,LAC,Los Angeles Clippers,1985,1,J. Lynam,lynamji99c,22,39,61
Los Angeles Clippers,LAC,Los Angeles Clippers,1985,2,D. Chaney,chanedo01c,9,12,21
Los Angeles Clippers,LAC,Los Angeles Clippers,1986,1,D. Chaney,chanedo01c,32,50,82
Los Angeles Clippers,LAC,Los Angeles Clippers,1987,1,D. Chaney,chanedo01c,12,70,82
Los Angeles Clippers,LAC,Los Angeles Clippers,1988,1,G. Shue,shuege01c,17,65,82
Los Angeles Clippers,LAC,Los Angeles Clippers,1989,1,G. Shue,shuege01c,10,28,38
Los Angeles Clippers,LAC,Los Angeles Clippers,1989,2,D. Casey,caseybo99c,11,33,44
Los Angeles Clippers,LAC,Los Angeles Clippers,1990,1,D. Casey,caseybo99c,30,52,82
Los Angeles Clippers,LAC,Los Angeles Clippers,1991,1,M. Schuler,schulmi99c,31,51,82
Los Angeles Clippers,LAC,Los Angeles Clippers,1992,1,M. Schuler,schulmi99c,21,24,45
Los Angeles Clippers,LAC,Los Angeles Clippers,1992,2,M. Calvin,calvima01c,1,1,2
Los Angeles Clippers,LAC,Los Angeles Clippers,1992,3,L. Brown,brownla01c,23,12,35
Los Angeles Clippers,LAC,Los Angeles Clippers,1993,1,L. Brown,brownla01c,41,41,82
Los Angeles Clippers,LAC,Los Angeles Clippers,1994,1,B. Weiss,weissbo01c,27,55,82
Los Angeles Clippers,LAC,Los Angeles Clippers,1995,1,B. Fitch,fitchbi99c,17,65,82
Los Angeles Clippers,LAC,Los Angeles Clippers,1996,1,B. Fitch,fitchbi99c,29,53,82
Los Angeles Clippers,LAC,Los Angeles Clippers,1997,1,B. Fitch,fitchbi99c,36,46,82
Los Angeles Clippers,LAC,Los Angeles Clippers,1998,1,B. Fitch,fitchbi99c,17,65,82
Los Angeles Clippers,LAC,Los Angeles Clippers,1999,1,C. Ford,fordch01c,9,41,50
Los Angeles Clippers,LAC,Los Angeles Clippers,2000,1,C. Ford,fordch01c,11,34,45
Los Angeles Clippers,LAC,Los Angeles Clippers,2000,2,J. Todd,toddji99c,4,33,37
Los Angeles Clippers,LAC,Los Angeles Clippers,2001,1,A. Gentry,gentral99c,31,51,82
Los Angeles Clippers,LAC,Los Angeles Clippers,2002,1,A. Gentry,gentral99c,39,43,82
Los Angeles Clippers,LAC,Los Angeles Clippers,2003,1,A. Gentry,gentral99c,19,39,58
Los Angeles Clippers,LAC,Los Angeles Clippers,2003,2,D. Johnson,johnsde01c,8,16,24
Los Angeles Clippers,LAC,Los Angeles Clippers,2004,1,M. Dunleavy,dunlemi01c,28,54,82
Los Angeles Clippers,LAC,Los Angeles Clippers,2005,1,M. Dunleavy,dunlemi01c,37,45,82
Los Angeles Clippers,LAC,Los Angeles Clippers,2006,1,M. Dunleavy,dunlemi01c,47,35,82
Los Angeles Clippers,LAC,Los Angeles Clippers,2007,1,M. Dunleavy,dunlemi01c,40,42,82
Los Angeles Clippers,LAC,Los Angeles Clippers,2008,1,M. Dunleavy,dunlemi01c,23,59,82
Los Angeles Clippers,LAC,Los Angeles Clippers,2009,1,M. Dunleavy,dunlemi01c,19,63,82
Los Angeles Clippers,LAC,Los Angeles Clippers,2010,1,M. Dunleavy,dunlemi01c,21,28,49
Los Angeles Clippers,LAC,Los Angeles Clippers,2010,2,K. Hughes,hugheki01c,8,25,33
Los Angeles Clippers,LAC,Los Angeles Clippers,2011,1,V. Del Negro,delnevi01c,32,50,82
Los Angeles Clippers,LAC,Los Angeles Clippers,2012,1,V. Del Negro,delnevi01c,40,26,66
Los Angeles Clippers,LAC,Los Angeles Clippers,2013,1,V. Del Negro,delnevi01c,56,26,82
Los Angeles Clippers,LAC,Los Angeles Clippers,2014,1,D. Rivers,riverdo01c,57,25,82
Los Angeles Clippers,LAC,Los Angeles Clippers,2015,1,D. Rivers,riverdo01c,56,26,82
Los Angeles Clippers,LAC,Los Angeles Clippers,2016,1,D. Rivers,riverdo01c,53,29,82
Los Angeles Clippers,LAC,Los Angeles Clippers,2017,1,D. Rivers,riverdo01c,51,31,82
Los Angeles Clippers,LAC,Los Angeles Clippers,2018,1,D. Rivers,riverdo01c,42,40,82
Los Angeles Clippers,LAC,Los Angeles Clippers,2019,1,D. Rivers,riverdo01c,48,34,82
Los Angeles Clippers,LAC,Los Angeles Clippers,2020,1,D. Rivers,riverdo01c,44,20,64
Los Angeles Lakers,LAL,Minneapolis Lakers,1949,1,J. Kundla,kundljo99c,44,16,60
Los Angeles Lakers,LAL,Minneapolis Lakers,1950,1,J. Kundla,kundljo99c,51,17,68
Los Angeles Lakers,LAL,Minneapolis Lakers,1951,1,J. Kundla,kundljo99c,44,24,68
Los Angeles Lakers,LAL,Minneapolis Lakers,1952,1,J. Kundla,kundljo99c,40,26,66
Los Angeles Lakers,LAL,Minneapolis Lakers,1953,1,J. Kundla,kundljo99c,48,22,70
Los Angeles Lakers,LAL,Minneapolis Lakers,1954,1,J. Kundla,kundljo99c,46,26,72
Los Angeles Lakers,LAL,Minneapolis Lakers,1955,1,J. Kundla,kundljo99c,40,32,72
Los Angeles Lakers,LAL,Minneapolis Lakers,1956,1,J. Kundla,kundljo99c,33,39,72
Los Angeles Lakers,LAL,Minneapolis Lakers,1957,1,J. Kundla,kundljo99c,34,38,72
Los Angeles Lakers,LAL,Minneapolis Lakers,1958,1,G. Mikan,mikange01c,9,30,39
Los Angeles Lakers,LAL,Minneapolis Lakers,1958,2,J. Kundla,kundljo99c,10,23,33
Los Angeles Lakers,LAL,Minneapolis Lakers,1959,1,J. Kundla,kundljo99c,33,39,72
Los Angeles Lakers,LAL,Minneapolis Lakers,1960,1,J. Castellani,castejo99c,11,25,36
Los Angeles Lakers,LAL,Minneapolis Lakers,1960,2,J. Pollard,pollaji01c,14,25,39
Los Angeles Lakers,LAL,Los Angeles Lakers,1961,1,F. Schaus,schaufr01c,36,43,79
Los Angeles Lakers,LAL,Los Angeles Lakers,1962,1,F. Schaus,schaufr01c,54,26,80
Los Angeles Lakers,LAL,Los Angeles Lakers,1963,1,F. Schaus,schaufr01c,53,27,80
Los Angeles Lakers,LAL,Los Angeles Lakers,1964,1,F. Schaus,schaufr01c,42,38,80
Los Angeles Lakers,LAL,Los Angeles Lakers,1965,1,F. Schaus,schaufr01c,49,31,80
Los Angeles Lakers,LAL,Los Angeles Lakers,1966,1,F. Schaus,schaufr01c,45,35,80
Los Angeles Lakers,LAL,Los Angeles Lakers,1967,1,F. Schaus,schaufr01c,36,45,81
Los Angeles Lakers,LAL,Los Angeles Lakers,1968,1,B. van Breda Kolff,vanbrbu01c,52,30,82
Los Angeles Lakers,LAL,Los Angeles Lakers,1969,1,B. van Breda Kolff,vanbrbu01c,55,27,82
Los Angeles Lakers,LAL,Los Angeles Lakers,1970,1,J. Mullaney,mullajo01c,46,36,82
Los Angeles Lakers,LAL,Los Angeles Lakers,1971,1,J. Mullaney,mullajo01c,48,34,82
Los Angeles Lakers,LAL,Los Angeles Lakers,1972,1,B. Sharman,sharmbi01c,69,13,82
Los Angeles Lakers,LAL,Los Angeles Lakers,1973,1,B. Sharman,sharmbi01c,60,22,82
Los Angeles Lakers,LAL,Los Angeles Lakers,1974,1,B. Sharman,sharmbi01c,47,35,82
Los Angeles Lakers,LAL,Los Angeles Lakers,1975,1,B. Sharman,sharmbi01c,30,52,82
Los Angeles Lakers,LAL,Los Angeles Lakers,1976,1,B. Sharman,sharmbi01c,40,42,82
Los Angeles Lakers,LAL,Los Angeles Lakers,1977,1,J. West,westje01c,53,29,82
Los Angeles Lakers,LAL,Los Angeles Lakers,1978,1,J. West,westje01c,45,37,82
Los Angeles Lakers,LAL,Los Angeles Lakers,1979,1,J. West,westje01c,47,35,82
Los Angeles Lakers,LAL,Los Angeles Lakers,1980,1,J. McKinney,mckinja99c,10,4,14
Los Angeles Lakers,LAL,Los Angeles Lakers,1980,2,P. Westhead,westhpa99c,50,18,68
Los Angeles Lakers,LAL,Los Angeles Lakers,1981,1,P. Westhead,westhpa99c,54,28,82
Los Angeles Lakers,LAL,Los Angeles Lakers,1982,1,P. Westhead,westhpa99c,7,4,11
Los Angeles Lakers,LAL,Los Angeles Lakers,1982,2,P. Riley,rileypa01c,50,21,71
Los Angeles Lakers,LAL,Los Angeles Lakers,1983,1,P. Riley,rileypa01c,58,24,82
Los Angeles Lakers,LAL,Los Angeles Lakers,1984,1,P. Riley,rileypa01c,54,28,82
Los Angeles Lakers,LAL,Los Angeles Lakers,1985,1,P. Riley,rileypa01c,62,20,82
Los Angeles Lakers,LAL,Los Angeles Lakers,1986,1,P. Riley,rileypa01c,62,20,82
Los Angeles Lakers,LAL,Los Angeles Lakers,1987,1,P. Riley,rileypa01c,65,17,82
Los Angeles Lakers,LAL,Los Angeles Lakers,1988,1,P. Riley,rileypa01c,62,20,82
Los Angeles Lakers,LAL,Los Angeles Lakers,1989,1,P. Riley,rileypa01c,57,25,82
Los Angeles Lakers,LAL,Los Angeles Lakers,1990,1,P. Riley,rileypa01c,63,19,82
Los Angeles Lakers,LAL,Los Angeles Lakers,1991,1,M. Dunleavy,dunlemi01c,58,24,82
Los Angeles Lakers,LAL,Los Angeles Lakers,1992,1,M. Dunleavy,dunlemi01c,43,39,82
Los Angeles Lakers,LAL,Los Angeles Lakers,1993,1,R. Pfund,pfundra99c,39,43,82
Los Angeles Lakers,LAL,Los Angeles Lakers,1994,1,R. Pfund,pfundra99c,27,37,64
Los Angeles Lakers,LAL,Los Angeles Lakers,1994,2,B. Bertka,bertkbi99c,1,1,2
Los Angeles Lakers,LAL,Los Angeles Lakers,1994,3,M. Johnson,johnsma02c,5,11,16
Los Angeles Lakers,LAL,Los Angeles Lakers,1995,1,D. Harris,harride99c,48,34,82
Los Angeles Lakers,LAL,Los Angeles Lakers,1996,1,D. Harris,harride99c,53,29,82
Los Angeles Lakers,LAL,Los Angeles Lakers,1997,1,D. Harris,harride99c,56,26,82
Los Angeles Lakers,LAL,Los Angeles Lakers,1998,1,D. Harris,harride99c,61,21,82
Los Angeles Lakers,LAL,Los Angeles Lakers,1999,1,D. Harris,harride99c,6,6,12
Los Angeles Lakers,LAL,Los Angeles Lakers,1999,2,B. Bertka,bertkbi99c,1,0,1
Los Angeles Lakers,LAL,Los Angeles Lakers,1999,3,K. Rambis,rambiku01c,24,13,37
Los Angeles Lakers,LAL,Los Angeles Lakers,2000,1,P. Jackson,jacksph01c,67,15,82
Los Angeles Lakers,LAL,Los Angeles Lakers,2001,1,P. Jackson,jacksph01c,56,26,82
Los Angeles Lakers,LAL,Los Angeles Lakers,2002,1,P. Jackson,jacksph01c,58,24,82
Los Angeles Lakers,LAL,Los Angeles Lakers,2003,1,P. Jackson,jacksph01c,50,32,82
Los Angeles Lakers,LAL,Los Angeles Lakers,2004,1,P. Jackson,jacksph01c,56,26,82
Los Angeles Lakers,LAL,Los Angeles Lakers,2005,1,R. Tomjanovich,tomjaru01c,24,19,43
Los Angeles Lakers,LAL,Los Angeles Lakers,2005,2,F. Hamblen,hamblfr99c,10,29,39
Los Angeles Lakers,LAL,Los Angeles Lakers,2006,1,P. Jackson,jacksph01c,45,37,82
Los Angeles Lakers,LAL,Los Angeles Lakers,2007,1,P. Jackson,jacksph01c,42,40,82
Los Angeles Lakers,LAL,Los Angeles Lakers,2008,1,P. Jackson,jacksph01c,57,25,82
Los Angeles Lakers,LAL,Los Angeles Lakers,2009,1,P. Jackson,jacksph01c,65,17,82
Los Angeles Lakers,LAL,Los Angeles Lakers,2010,1,P. Jackson,jacksph01c,57,25,82
Los Angeles Lakers,LAL,Los Angeles Lakers,2011,1,P. Jackson,jacksph01c,57,25,82
Los Angeles Lakers,LAL,Los Angeles Lakers,2012,1,M. Brown,brownmi99c,41,25,66
Los Angeles Lakers,LAL,Los Angeles Lakers,2013,1,M. Brown,brownmi99c,1,4,5
Los Angeles Lakers,LAL,Los Angeles Lakers,2013,2,B. Bickerstaff,bickebe99c,4,1,5
Los Angeles Lakers,LAL,Los Angeles Lakers,2013,3,M. D'Antoni,dantomi01c,40,32,72
Los Angeles Lakers,LAL,Los Angeles Lakers,2014,1,M. D'Antoni,dantomi01c,27,55,82
Los Angeles Lakers,LAL,Los Angeles Lakers,2015,1,B. Scott,scottby01c,21,61,82
Los Angeles Lakers,LAL,Los Angeles Lakers,2016,1,B. Scott,scottby01c,17,65,82
Los Angeles Lakers,LAL,Los Angeles Lakers,2017,1,L. Walton,waltolu01c,26,56,82
Los Angeles Lakers,LAL,Los Angeles Lakers,2018,1,L. Walton,waltolu01c,35,47,82
Los Angeles Lakers,LAL,Los Angeles Lakers,2019,1,L. Walton,waltolu01c,37,45,82
Los Angeles Lakers,LAL,Los Angeles Lakers,2020,1,F. Vogel,vogelfr99c,49,14,63
Memphis Grizzlies,MEM,Vancouver Grizzlies,1996,1,B. Winters,wintebr01c,15,67,82
Memphis Grizzlies,MEM,Vancouver Grizzlies,1997,1,B. Winters,wintebr01c,8,35,43
Memphis Grizzlies,MEM,Vancouver Grizzlies,1997,2,S. Jackson,jacksst99c,6,33,39
Memphis Grizzlies,MEM,Vancouver Grizzlies,1998,1,B. Hill,hillbr99c,19,63,82
Memphis Grizzlies,MEM,Vancouver Grizzlies,1999,1,B. Hill,hillbr99c,8,42,50
Memphis Grizzlies,MEM,Vancouver Grizzlies,2000,1,B. Hill,hillbr99c,4,18,22
Memphis Grizzlies,MEM,Vancouver Grizzlies,2000,2,L. Hollins,hollili01c,18,42,60
Memphis Grizzlies,MEM,Vancouver Grizzlies,2001,1,S. Lowe,lowesi01c,23,59,82
Memphis Grizzlies,MEM,Memphis Grizzlies,2002,1,S. Lowe,lowesi01c,23,59,82
Memphis Grizzlies,MEM,Memphis Grizzlies,2003,1,S. Lowe,lowesi01c,0,8,8
Memphis Grizzlies,MEM,Memphis Grizzlies,2003,2,H. Brown,brownhu99c,28,46,74
Memphis Grizzlies,MEM,Memphis Grizzlies,2004,1,H. Brown,brownhu99c,50,32,82
Memphis Grizzlies,MEM,Memphis Grizzlies,2005,1,H. Brown,brownhu99c,5,7,12
Memphis Grizzlies,MEM,Memphis Grizzlies,2005,2,L. Hollins,hollili01c,0,4,4
Memphis Grizzlies,MEM,Memphis Grizzlies,2005,3,M. Fratello,fratemi99c,40,26,66
Memphis Grizzlies,MEM,Memphis Grizzlies,2006,1,M. Fratello,fratemi99c,49,33,82
Memphis Grizzlies,MEM,Memphis Grizzlies,2007,1,M. Fratello,fratemi99c,6,24,30
Memphis Grizzlies,MEM,Memphis Grizzlies,2007,2,T. Barone,baronto99c,16,36,52
Memphis Grizzlies,MEM,Memphis Grizzlies,2008,1,M. Iavaroni,iavarma01c,22,60,82
Memphis Grizzlies,MEM,Memphis Grizzlies,2009,1,M. Iavaroni,iavarma01c,11,30,41
Memphis Grizzlies,MEM,Memphis Grizzlies,2009,2,J. Davis,davisjo01c,0,2,2
Memphis Grizzlies,MEM,Memphis Grizzlies,2009,3,L. Hollins,hollili01c,13,26,39
Memphis Grizzlies,MEM,Memphis Grizzlies,2010,1,L. Hollins,hollili01c,40,42,82
Memphis Grizzlies,MEM,Memphis Grizzlies,2011,1,L. Hollins,hollili01c,46,36,82
Memphis Grizzlies,MEM,Memphis Grizzlies,2012,1,L. Hollins,hollili01c,41,25,66
Memphis Grizzlies,MEM,Memphis Grizzlies,2013,1,L. Hollins,hollili01c,56,26,82
Memphis Grizzlies,MEM,Memphis Grizzlies,2014,1,D. Joerger,joergda99c,50,32,82
Memphis Grizzlies,MEM,Memphis Grizzlies,2015,1,D. Joerger,joergda99c,55,27,82
Memphis Grizzlies,MEM,Memphis Grizzlies,2016,1,D. Joerger,joergda99c,42,40,82
Memphis Grizzlies,MEM,Memphis Grizzlies,2017,1,D. Fizdale,fizdada01c,43,39,82
Memphis Grizzlies,MEM,Memphis Grizzlies,2018,1,D. Fizdale,fizdada01c,7,12,19
Memphis Grizzlies,MEM,Memphis Grizzlies,2018,2,J. Bickerstaff,bickejb01c,15,48,63
Memphis Grizzlies,MEM,Memphis Grizzlies,2019,1,J. Bickerstaff,bickejb01c,33,49,82
Memphis Grizzlies,MEM,Memphis Grizzlies,2020,1,T. Jenkins,jenkita01c,32,33,65
Miami Heat,MIA,Miami Heat,1989,1,R. Rothstein,rothsro99c,15,67,82
Miami Heat,MIA,Miami Heat,1990,1,R. Rothstein,rothsro99c,18,64,82
Miami Heat,MIA,Miami Heat,1991,1,R. Rothstein,rothsro99c,24,58,82
Miami Heat,MIA,Miami Heat,1992,1,K. Loughery,loughke01c,38,44,82
Miami Heat,MIA,Miami Heat,1993,1,K. Loughery,loughke01c,36,46,82
Miami Heat,MIA,Miami Heat,1994,1,K. Loughery,loughke01c,42,40,82
Miami Heat,MIA,Miami Heat,1995,1,K. Loughery,loughke01c,17,29,46
Miami Heat,MIA,Miami Heat,1995,2,A. Gentry,gentral99c,15,21,36
Miami Heat,MIA,Miami Heat,1996,1,P. Riley,rileypa01c,42,40,82
Miami Heat,MIA,Miami Heat,1997,1,P. Riley,rileypa01c,61,21,82
Miami Heat,MIA,Miami Heat,1998,1,P. Riley,rileypa01c,55,27,82
Miami Heat,MIA,Miami Heat,1999,1,P. Riley,rileypa01c,33,17,50
Miami Heat,MIA,Miami Heat,2000,1,P. Riley,rileypa01c,52,30,82
Miami Heat,MIA,Miami Heat,2001,1,P. Riley,rileypa01c,50,32,82
Miami Heat,MIA,Miami Heat,2002,1,P. Riley,rileypa01c,36,46,82
Miami Heat,MIA,Miami Heat,2003,1,P. Riley,rileypa01c,25,57,82
Miami Heat,MIA,Miami Heat,2004,1,S. Van Gundy,vangust99c,42,40,82
Miami Heat,MIA,Miami Heat,2005,1,S. Van Gundy,vangust99c,59,23,82
Miami Heat,MIA,Miami Heat,2006,1,S. Van Gundy,vangust99c,11,10,21
Miami Heat,MIA,Miami Heat,2006,2,P. Riley,rileypa01c,41,20,61
Miami Heat,MIA,Miami Heat,2007,1,P. Riley,rileypa01c,44,38,82
Miami Heat,MIA,Miami Heat,2008,1,P. Riley,rileypa01c,15,67,82
Miami Heat,MIA,Miami Heat,2009,1,E. Spoelstra,spoeler99c,43,39,82
Miami Heat,MIA,Miami Heat,2010,1,E. Spoelstra,spoeler99c,47,35,82
Miami Heat,MIA,Miami Heat,2011,1,E. Spoelstra,spoeler99c,58,24,82
Miami Heat,MIA,Miami Heat,2012,1,E. Spoelstra,spoeler99c,46,20,66
Miami Heat,MIA,Miami Heat,2013,1,E. Spoelstra,spoeler99c,66,16,82
Miami Heat,MIA,Miami Heat,2014,1,E. Spoelstra,spoeler99c,54,28,82
Miami Heat,MIA,Miami Heat,2015,1,E. Spoelstra,spoeler99c,37,45,82
Miami Heat,MIA,Miami Heat,2016,1,E. Spoelstra,spoeler99c,48,34,82
Miami Heat,MIA,Miami Heat,2017,1,E. Spoelstra,spoeler99c,41,41,82
Miami Heat,MIA,Miami Heat,2018,1,E. Spoelstra,spoeler99c,44,38,82
Miami Heat,MIA,Miami Heat,2019,1,E. Spoelstra,spoeler99c,39,43,82
Miami Heat,MIA,Miami Heat,2020,1,E. Spoelstra,spoeler99c,41,24,65
Milwaukee Bucks,MIL,Milwaukee Bucks,1969,1,L. Costello,costela01c,27,55,82
Milwaukee Bucks,MIL,Milwaukee Bucks,1970,1,L. Costello,costela01c,56,26,82
Milwaukee Bucks,MIL,Milwaukee Bucks,1971,1,L. Costello,costela01c,66,16,82
Milwaukee Bucks,MIL,Milwaukee Bucks,1972,1,L. Costello,costela01c,63,19,82
Milwaukee Bucks,MIL,Milwaukee Bucks,1973,1,L. Costello,costela01c,60,22,82
Milwaukee Bucks,MIL,Milwaukee Bucks,1974,1,L. Costello,costela01c,59,23,82
Milwaukee Bucks,MIL,Milwaukee Bucks,1975,1,L. Costello,costela01c,38,44,82
Milwaukee Bucks,MIL,Milwaukee Bucks,1976,1,L. Costello,costela01c,38,44,82
Milwaukee Bucks,MIL,Milwaukee Bucks,1977,1,L. Costello,costela01c,3,15,18
Milwaukee Bucks,MIL,Milwaukee Bucks,1977,2,D. Nelson,nelsodo01c,27,37,64
Milwaukee Bucks,MIL,Milwaukee Bucks,1978,1,D. Nelson,nelsodo01c,44,38,82
Milwaukee Bucks,MIL,Milwaukee Bucks,1979,1,D. Nelson,nelsodo01c,38,44,82
Milwaukee Bucks,MIL,Milwaukee Bucks,1980,1,D. Nelson,nelsodo01c,49,33,82
Milwaukee Bucks,MIL,Milwaukee Bucks,1981,1,D. Nelson,nelsodo01c,60,22,82
Milwaukee Bucks,MIL,Milwaukee Bucks,1982,1,D. Nelson,nelsodo01c,55,27,82
Milwaukee Bucks,MIL,Milwaukee Bucks,1983,1,D. Nelson,nelsodo01c,51,31,82
Milwaukee Bucks,MIL,Milwaukee Bucks,1984,1,D. Nelson,nelsodo01c,50,32,82
Milwaukee Bucks,MIL,Milwaukee Bucks,1985,1,D. Nelson,nelsodo01c,59,23,82
Milwaukee Bucks,MIL,Milwaukee Bucks,1986,1,D. Nelson,nelsodo01c,57,25,82
Milwaukee Bucks,MIL,Milwaukee Bucks,1987,1,D. Nelson,nelsodo01c,50,32,82
Milwaukee Bucks,MIL,Milwaukee Bucks,1988,1,D. Harris,harride99c,42,40,82
Milwaukee Bucks,MIL,Milwaukee Bucks,1989,1,D. Harris,harride99c,49,33,82
Milwaukee Bucks,MIL,Milwaukee Bucks,1990,1,D. Harris,harride99c,44,38,82
Milwaukee Bucks,MIL,Milwaukee Bucks,1991,1,D. Harris,harride99c,48,34,82
Milwaukee Bucks,MIL,Milwaukee Bucks,1992,1,D. Harris,harride99c,8,9,17
Milwaukee Bucks,MIL,Milwaukee Bucks,1992,2,F. Hamblen,hamblfr99c,23,42,65
Milwaukee Bucks,MIL,Milwaukee Bucks,1993,1,M. Dunleavy,dunlemi01c,28,54,82
Milwaukee Bucks,MIL,Milwaukee Bucks,1994,1,M. Dunleavy,dunlemi01c,20,62,82
Milwaukee Bucks,MIL,Milwaukee Bucks,1995,1,M. Dunleavy,dunlemi01c,34,48,82
Milwaukee Bucks,MIL,Milwaukee Bucks,1996,1,M. Dunleavy,dunlemi01c,25,57,82
Milwaukee Bucks,MIL,Milwaukee Bucks,1997,1,C. Ford,fordch01c,33,49,82
Milwaukee Bucks,MIL,Milwaukee Bucks,1998,1,C. Ford,fordch01c,36,46,82
Milwaukee Bucks,MIL,Milwaukee Bucks,1999,1,G. Karl,karlge01c,28,22,50
Milwaukee Bucks,MIL,Milwaukee Bucks,2000,1,G. Karl,karlge01c,42,40,82
Milwaukee Bucks,MIL,Milwaukee Bucks,2001,1,G. Karl,karlge01c,52,30,82
Milwaukee Bucks,MIL,Milwaukee Bucks,2002,1,G. Karl,karlge01c,41,41,82
Milwaukee Bucks,MIL,Milwaukee Bucks,2003,1,G. Karl,karlge01c,42,40,82
Milwaukee Bucks,MIL,Milwaukee Bucks,2004,1,T. Porter,portete01c,41,41,82
Milwaukee Bucks,MIL,Milwaukee Bucks,2005,1,T. Porter,portete01c,30,52,82
Milwaukee Bucks,MIL,Milwaukee Bucks,2006,1,T. Stotts,stottte99c,40,42,82
Milwaukee Bucks,MIL,Milwaukee Bucks,2007,1,T. Stotts,stottte99c,23,41,64
Milwaukee Bucks,MIL,Milwaukee Bucks,2007,2,L. Krystkowiak,krystla01c,5,13,18
Milwaukee Bucks,MIL,Milwaukee Bucks,2008,1,L. Krystkowiak,krystla01c,26,56,82
Milwaukee Bucks,MIL,Milwaukee Bucks,2009,1,S. Skiles,skilesc01c,34,48,82
Milwaukee Bucks,MIL,Milwaukee Bucks,2010,1,S. Skiles,skilesc01c,46,36,82
Milwaukee Bucks,MIL,Milwaukee Bucks,2011,1,S. Skiles,skilesc01c,35,47,82
Milwaukee Bucks,MIL,Milwaukee Bucks,2012,1,S. Skiles,skilesc01c,31,35,66
Milwaukee Bucks,MIL,Milwaukee Bucks,2013,1,S. Skiles,skilesc01c,16,16,32
Milwaukee Bucks,MIL,Milwaukee Bucks,2013,2,J. Boylan,boylaji99c,22,28,50
Milwaukee Bucks,MIL,Milwaukee Bucks,2014,1,L. Drew,drewla01c,15,67,82
Milwaukee Bucks,MIL,Milwaukee Bucks,2015,1,J. Kidd,kiddja01c,41,41,82
Milwaukee Bucks,MIL,Milwaukee Bucks,2016,1,J. Kidd,kiddja01c,33,49,82
Milwaukee Bucks,MIL,Milwaukee Bucks,2017,1,J. Kidd,kiddja01c,42,40,82
Milwaukee Bucks,MIL,Milwaukee Bucks,2018,1,J. Kidd,kiddja01c,23,22,45
Milwaukee Bucks,MIL,Milwaukee Bucks,2018,2,J. Prunty,pruntjo01c,21,16,37
Milwaukee Bucks,MIL,Milwaukee Bucks,2019,1,M. Budenholzer,budenmi99c,60,22,82
Milwaukee Bucks,MIL,Milwaukee Bucks,2020,1,M. Budenholzer,budenmi99c,53,12,65
Minnesota Timberwolves,MIN,Minnesota Timberwolves,1990,1,B. Musselman,mussebi99c,22,60,82
Minnesota Timberwolves,MIN,Minnesota Timberwolves,1991,1,B. Musselman,mussebi99c,29,53,82
Minnesota Timberwolves,MIN,Minnesota Timberwolves,1992,1,J. Rodgers,rodgeji99c,15,67,82
Minnesota Timberwolves,MIN,Minnesota Timberwolves,1993,1,J. Rodgers,rodgeji99c,6,23,29
Minnesota Timberwolves,MIN,Minnesota Timberwolves,1993,2,S. Lowe,lowesi01c,13,40,53
Minnesota Timberwolves,MIN,Minnesota Timberwolves,1994,1,S. Lowe,lowesi01c,20,62,82
Minnesota Timberwolves,MIN,Minnesota Timberwolves,1995,1,B. Blair,blairbi99c,21,61,82
Minnesota Timberwolves,MIN,Minnesota Timberwolves,1996,1,B. Blair,blairbi99c,6,14,20
Minnesota Timberwolves,MIN,Minnesota Timberwolves,1996,2,F. Saunders,saundfl99c,20,42,62
Minnesota Timberwolves,MIN,Minnesota Timberwolves,1997,1,F. Saunders,saundfl99c,40,42,82
Minnesota Timberwolves,MIN,Minnesota Timberwolves,1998,1,F. Saunders,saundfl99c,45,37,82
Minnesota Timberwolves,MIN,Minnesota Timberwolves,1999,1,F. Saunders,saundfl99c,25,25,50
Minnesota Timberwolves,MIN,Minnesota Timberwolves,2000,1,F. Saunders,saundfl99c,50,32,82
Minnesota Timberwolves,MIN,Minnesota Timberwolves,2001,1,F. Saunders,saundfl99c,47,35,82
Minnesota Timberwolves,MIN,Minnesota Timberwolves,2002,1,F. Saunders,saundfl99c,50,32,82
Minnesota Timberwolves,MIN,Minnesota Timberwolves,2003,1,F. Saunders,saundfl99c,51,31,82
Minnesota Timberwolves,MIN,Minnesota Timberwolves,2004,1,F. Saunders,saundfl99c,58,24,82
Minnesota Timberwolves,MIN,Minnesota Timberwolves,2005,1,F. Saunders,saundfl99c,25,26,51
Minnesota Timberwolves,MIN,Minnesota Timberwolves,2005,2,K. McHale,mchalke01c,19,12,31
Minnesota Timberwolves,MIN,Minnesota Timberwolves,2006,1,D. Casey,caseydw99c,33,49,82
Minnesota Timberwolves,MIN,Minnesota Timberwolves,2007,1,D. Casey,caseydw99c,20,20,40
Minnesota Timberwolves,MIN,Minnesota Timberwolves,2007,2,R. Wittman,wittmra01c,12,30,42
Minnesota Timberwolves,MIN,Minnesota Timberwolves,2008,1,R. Wittman,wittmra01c,22,60,82
Minnesota Timberwolves,MIN,Minnesota Timberwolves,2009,1,R. Wittman,wittmra01c,4,15,19
Minnesota Timberwolves,MIN,Minnesota Timberwolves,2009,2,K. McHale,mchalke01c,20,43,63
Minnesota Timberwolves,MIN,Minnesota Timberwolves,2010,1,K. Rambis,rambiku01c,15,67,82
Minnesota Timberwolves,MIN,Minnesota Timberwolves,2011,1,K. Rambis,rambiku01c,17,65,82
Minnesota Timberwolves,MIN,Minnesota Timberwolves,2012,1,R. Adelman,adelmri01c,26,40,66
Minnesota Timberwolves,MIN,Minnesota Timberwolves,2013,1,R. Adelman,adelmri01c,31,51,82
Minnesota Timberwolves,MIN,Minnesota Timberwolves,2014,1,R. Adelman,adelmri01c,40,42,82
Minnesota Timberwolves,MIN,Minnesota Timberwolves,2015,1,F. Saunders,saundfl99c,16,66,82
Minnesota Timberwolves,MIN,Minnesota Timberwolves,2016,1,S. Mitchell,mitchsa01c,29,53,82
Minnesota Timberwolves,MIN,Minnesota Timberwolves,2017,1,T. Thibodeau,thiboto99c,31,51,82
Minnesota Timberwolves,MIN,Minnesota Timberwolves,2018,1,T. Thibodeau,thiboto99c,47,35,82
Minnesota Timberwolves,MIN,Minnesota Timberwolves,2019,1,T. Thibodeau,thiboto99c,19,21,40
Minnesota Timberwolves,MIN,Minnesota Timberwolves,2019,2,R. Saunders,saundry01c,17,25,42
Minnesota Timberwolves,MIN,Minnesota Timberwolves,2020,1,R. Saunders,saundry01c,19,45,64
New Orleans Pelicans,NOH,New Orleans Hornets,2003,1,P. Silas,silaspa01c,47,35,82
New Orleans Pelicans,NOH,New Orleans Hornets,2004,1,T. Floyd,floydti99c,41,41,82
New Orleans Pelicans,NOH,New Orleans Hornets,2005,1,B. Scott,scottby01c,18,64,82
New Orleans Pelicans,NOH,New Orleans/Oklahoma City Hornets,2006,1,B. Scott,scottby01c,38,44,82
New Orleans Pelicans,NOH,New Orleans/Oklahoma City Hornets,2007,1,B. Scott,scottby01c,39,43,82
New Orleans Pelicans,NOH,New Orleans Hornets,2008,1,B. Scott,scottby01c,56,26,82
New Orleans Pelicans,NOH,New Orleans Hornets,2009,1,B. Scott,scottby01c,49,33,82
New Orleans Pelicans,NOH,New Orleans Hornets,2010,1,B. Scott,scottby01c,3,6,9
New Orleans Pelicans,NOH,New Orleans Hornets,2010,2,J. Bower,bowerje99c,34,39,73
New Orleans Pelicans,NOH,New Orleans Hornets,2011,1,M. Williams,willimo01c,46,36,82
New Orleans Pelicans,NOH,New Orleans Hornets,2012,1,M. Williams,willimo01c,21,45,66
New Orleans Pelicans,NOH,New Orleans Hornets,2013,1,M. Williams,willimo01c,27,55,82
New Orleans Pelicans,NOH,New Orleans Pelicans,2014,1,M. Williams,willimo01c,34,48,82
New Orleans Pelicans,NOH,New Orleans Pelicans,2015,1,M. Williams,willimo01c,45,37,82
New Orleans Pelicans,NOH,New Orleans Pelicans,2016,1,A. Gentry,gentral99c,30,52,82
New Orleans Pelicans,NOH,New Orleans Pelicans,2017,1,A. Gentry,gentral99c,34,48,82
New Orleans Pelicans,NOH,New Orleans Pelicans,2018,1,A. Gentry,gentral99c,48,34,82
New Orleans Pelicans,NOH,New Orleans Pelicans,2019,1,A. Gentry,gentral99c,33,49,82
New Orleans Pelicans,NOH,New Orleans Pelicans,2020,1,A. Gentry,gentral99c,28,36,64
New York Knicks,NYK,New York Knicks,1947,1,N. Cohalan,cohalne99c,33,27,60
New York Knicks,NYK,New York Knicks,1948,1,J. Lapchick,lapchjo99c,26,22,48
New York Knicks,NYK,New York Knicks,1949,1,J. Lapchick,lapchjo99c,32,28,60
New York Knicks,NYK,New York Knicks,1950,1,J. Lapchick,lapchjo99c,40,28,68
New York Knicks,NYK,New York Knicks,1951,1,J. Lapchick,lapchjo99c,36,30,66
New York Knicks,NYK,New York Knicks,1952,1,J. Lapchick,lapchjo99c,37,29,66
New York Knicks,NYK,New York Knicks,1953,1,J. Lapchick,lapchjo99c,47,23,70
New York Knicks,NYK,New York Knicks,1954,1,J. Lapchick,lapchjo99c,44,28,72
New York Knicks,NYK,New York Knicks,1955,1,J. Lapchick,lapchjo99c,38,34,72
New York Knicks,NYK,New York Knicks,1956,1,J. Lapchick,lapchjo99c,26,25,51
New York Knicks,NYK,New York Knicks,1956,2,V. Boryla,borylvi01c,9,12,21
New York Knicks,NYK,New York Knicks,1957,1,V. Boryla,borylvi01c,36,36,72
New York Knicks,NYK,New York Knicks,1958,1,V. Boryla,borylvi01c,35,37,72
New York Knicks,NYK,New York Knicks,1959,1,A. Levane,levanan01c,40,32,72
New York Knicks,NYK,New York Knicks,1960,1,A. Levane,levanan01c,8,19,27
New York Knicks,NYK,New York Knicks,1960,2,C. Braun,braunca01c,19,29,48
New York Knicks,NYK,New York Knicks,1961,1,C. Braun,braunca01c,21,58,79
New York Knicks,NYK,New York Knicks,1962,1,E. Donovan,donoved99c,29,51,80
New York Knicks,NYK,New York Knicks,1963,1,E. Donovan,donoved99c,21,59,80
New York Knicks,NYK,New York Knicks,1964,1,E. Donovan,donoved99c,22,58,80
New York Knicks,NYK,New York Knicks,1965,1,E. Donovan,donoved99c,12,26,38
New York Knicks,NYK,New York Knicks,1965,2,H. Gallatin,gallaha01c,19,23,42
New York Knicks,NYK,New York Knicks,1966,1,H. Gallatin,gallaha01c,6,15,21
New York Knicks,NYK,New York Knicks,1966,2,D. McGuire,mcguidi01c,24,35,59
New York Knicks,NYK,New York Knicks,1967,1,D. McGuire,mcguidi01c,36,45,81
New York Knicks,NYK,New York Knicks,1968,1,D. McGuire,mcguidi01c,15,23,38
New York Knicks,NYK,New York Knicks,1968,2,R. Holzman,holzmre01c,28,16,44
New York Knicks,NYK,New York Knicks,1969,1,R. Holzman,holzmre01c,54,28,82
New York Knicks,NYK,New York Knicks,1970,1,R. Holzman,holzmre01c,60,22,82
New York Knicks,NYK,New York Knicks,1971,1,R. Holzman,holzmre01c,52,30,82
New York Knicks,NYK,New York Knicks,1972,1,R. Holzman,holzmre01c,48,34,82
New York Knicks,NYK,New York Knicks,1973,1,R. Holzman,holzmre01c,57,25,82
New York Knicks,NYK,New York Knicks,1974,1,R. Holzman,holzmre01c,49,33,82
New York Knicks,NYK,New York Knicks,1975,1,R. Holzman,holzmre01c,40,42,82
New York Knicks,NYK,New York Knicks,1976,1,R. Holzman,holzmre01c,38,44,82
New York Knicks,NYK,New York Knicks,1977,1,R. Holzman,holzmre01c,40,42,82
New York Knicks,NYK,New York Knicks,1978,1,W. Reed,reedwi01c,43,39,82
New York Knicks,NYK,New York Knicks,1979,1,W. Reed,reedwi01c,6,8,14
New York Knicks,NYK,New York Knicks,1979,2,R. Holzman,holzmre01c,25,43,68
New York Knicks,NYK,New York Knicks,1980,1,R. Holzman,holzmre01c,39,43,82
New York Knicks,NYK,New York Knicks,1981,1,R. Holzman,holzmre01c,50,32,82
New York Knicks,NYK,New York Knicks,1982,1,R. Holzman,holzmre01c,33,49,82
New York Knicks,NYK,New York Knicks,1983,1,H. Brown,brownhu99c,44,38,82
New York Knicks,NYK,New York Knicks,1984,1,H. Brown,brownhu99c,47,35,82
New York Knicks,NYK,New York Knicks,1985,1,H. Brown,brownhu99c,24,58,82
New York Knicks,NYK,New York Knicks,1986,1,H. Brown,brownhu99c,23,59,82
New York Knicks,NYK,New York Knicks,1987,1,H. Brown,brownhu99c,4,12,16
New York Knicks,NYK,New York Knicks,1987,2,B. Hill,hillbo99c,20,46,66
New York Knicks,NYK,New York Knicks,1988,1,R. Pitino,pitinri99c,38,44,82
New York Knicks,NYK,New York Knicks,1989,1,R. Pitino,pitinri99c,52,30,82
New York Knicks,NYK,New York Knicks,1990,1,S. Jackson,jacksst99c,45,37,82
New York Knicks,NYK,New York Knicks,1991,1,S. Jackson,jacksst99c,7,8,15
New York Knicks,NYK,New York Knicks,1991,2,J. MacLeod,maclejo99c,32,35,67
New York Knicks,NYK,New York Knicks,1992,1,P. Riley,rileypa01c,51,31,82
New York Knicks,NYK,New York Knicks,1993,1,P. Riley,rileypa01c,60,22,82
New York Knicks,NYK,New York Knicks,1994,1,P. Riley,rileypa01c,57,25,82
New York Knicks,NYK,New York Knicks,1995,1,P. Riley,rileypa01c,55,27,82
New York Knicks,NYK,New York Knicks,1996,1,D. Nelson,nelsodo01c,34,25,59
New York Knicks,NYK,New York Knicks,1996,2,J. Van Gundy,vanguje99c,13,10,23
New York Knicks,NYK,New York Knicks,1997,1,J. Van Gundy,vanguje99c,57,25,82
New York Knicks,NYK,New York Knicks,1998,1,J. Van Gundy,vanguje99c,43,39,82
New York Knicks,NYK,New York Knicks,1999,1,J. Van Gundy,vanguje99c,27,23,50
New York Knicks,NYK,New York Knicks,2000,1,J. Van Gundy,vanguje99c,50,32,82
New York Knicks,NYK,New York Knicks,2001,1,J. Van Gundy,vanguje99c,48,34,82
New York Knicks,NYK,New York Knicks,2002,1,J. Van Gundy,vanguje99c,10,9,19
New York Knicks,NYK,New York Knicks,2002,2,D. Chaney,chanedo01c,20,43,63
New York Knicks,NYK,New York Knicks,2003,1,D. Chaney,chanedo01c,37,45,82
New York Knicks,NYK,New York Knicks,2004,1,D. Chaney,chanedo01c,15,24,39
New York Knicks,NYK,New York Knicks,2004,2,H. Williams,willihe01c,1,0,1
New York Knicks,NYK,New York Knicks,2004,3,L. Wilkens,wilkele01c,23,19,42
New York Knicks,NYK,New York Knicks,2005,1,L. Wilkens,wilkele01c,17,22,39
New York Knicks,NYK,New York Knicks,2005,2,H. Williams,willihe01c,16,27,43
New York Knicks,NYK,New York Knicks,2006,1,L. Brown,brownla01c,23,59,82
New York Knicks,NYK,New York Knicks,2007,1,I. Thomas,thomais01c,33,49,82
New York Knicks,NYK,New York Knicks,2008,1,I. Thomas,thomais01c,23,59,82
New York Knicks,NYK,New York Knicks,2009,1,M. D'Antoni,dantomi01c,32,50,82
New York Knicks,NYK,New York Knicks,2010,1,M. D'Antoni,dantomi01c,29,53,82
New York Knicks,NYK,New York Knicks,2011,1,M. D'Antoni,dantomi01c,42,40,82
New York Knicks,NYK,New York Knicks,2012,1,M. D'Antoni,dantomi01c,18,24,42
New York Knicks,NYK,New York Knicks,2012,2,M. Woodson,woodsmi01c,18,6,24
New York Knicks,NYK,New York Knicks,2013,1,M. Woodson,woodsmi01c,54,28,82
New York Knicks,NYK,New York Knicks,2014,1,M. Woodson,woodsmi01c,37,45,82
New York Knicks,NYK,New York Knicks,2015,1,D. Fisher,fishede01c,17,65,82
New York Knicks,NYK,New York Knicks,2016,1,D. Fisher,fishede01c,23,31,54
New York Knicks,NYK,New York Knicks,2016,2,K. Rambis,rambiku01c,9,19,28
New York Knicks,NYK,New York Knicks,2017,1,J. Hornacek,hornaje01c,31,51,82
New York Knicks,NYK,New York Knicks,2018,1,J. Hornacek,hornaje01c,29,53,82
New York Knicks,NYK,New York Knicks,2019,1,D. Fizdale,fizdada01c,17,65,82
New York Knicks,NYK,New York Knicks,2020,1,D. Fizdale,fizdada01c,4,18,22
New York Knicks,NYK,New York Knicks,2020,2,M. Miller,millemi99c,17,27,44
Oklahoma City Thunder,OKC,Seattle SuperSonics,1968,1,A. Bianchi,biancal01c,23,59,82
Oklahoma City Thunder,OKC,Seattle SuperSonics,1969,1,A. Bianchi,biancal01c,30,52,82
Oklahoma City Thunder,OKC,Seattle SuperSonics,1970,1,L. Wilkens,wilkele01c,36,46,82
Oklahoma City Thunder,OKC,Seattle SuperSonics,1971,1,L. Wilkens,wilkele01c,38,44,82
Oklahoma City Thunder,OKC,Seattle SuperSonics,1972,1,L. Wilkens,wilkele01c,47,35,82
Oklahoma City Thunder,OKC,Seattle SuperSonics,1973,1,T. Nissalke,nissato99c,13,32,45
Oklahoma City Thunder,OKC,Seattle SuperSonics,1973,2,B. Buckwalter,buckwbu99c,13,24,37
Oklahoma City Thunder,OKC,Seattle SuperSonics,1974,1,B. Russell,russebi01c,36,46,82
Oklahoma City Thunder,OKC,Seattle SuperSonics,1975,1,B. Russell,russebi01c,43,39,82
Oklahoma City Thunder,OKC,Seattle SuperSonics,1976,1,B. Russell,russebi01c,43,39,82
Oklahoma City Thunder,OKC,Seattle SuperSonics,1977,1,B. Russell,russebi01c,40,42,82
Oklahoma City Thunder,OKC,Seattle SuperSonics,1978,1,B. Hopkins,hopkibo01c,5,17,22
Oklahoma City Thunder,OKC,Seattle SuperSonics,1978,2,L. Wilkens,wilkele01c,42,18,60
Oklahoma City Thunder,OKC,Seattle SuperSonics,1979,1,L. Wilkens,wilkele01c,52,30,82
Oklahoma City Thunder,OKC,Seattle SuperSonics,1980,1,L. Wilkens,wilkele01c,56,26,82
Oklahoma City Thunder,OKC,Seattle SuperSonics,1981,1,L. Wilkens,wilkele01c,34,48,82
Oklahoma City Thunder,OKC,Seattle SuperSonics,1982,1,L. Wilkens,wilkele01c,52,30,82
Oklahoma City Thunder,OKC,Seattle SuperSonics,1983,1,L. Wilkens,wilkele01c,48,34,82
Oklahoma City Thunder,OKC,Seattle SuperSonics,1984,1,L. Wilkens,wilkele01c,42,40,82
Oklahoma City Thunder,OKC,Seattle SuperSonics,1985,1,L. Wilkens,wilkele01c,31,51,82
Oklahoma City Thunder,OKC,Seattle SuperSonics,1986,1,B. Bickerstaff,bickebe99c,31,51,82
Oklahoma City Thunder,OKC,Seattle SuperSonics,1987,1,B. Bickerstaff,bickebe99c,39,43,82
Oklahoma City Thunder,OKC,Seattle SuperSonics,1988,1,B. Bickerstaff,bickebe99c,44,38,82
Oklahoma City Thunder,OKC,Seattle SuperSonics,1989,1,B. Bickerstaff,bickebe99c,47,35,82
Oklahoma City Thunder,OKC,Seattle SuperSonics,1990,1,B. Bickerstaff,bickebe99c,41,41,82
Oklahoma City Thunder,OKC,Seattle SuperSonics,1991,1,K. Jones,joneskc01c,41,41,82
Oklahoma City Thunder,OKC,Seattle SuperSonics,1992,1,K. Jones,joneskc01c,18,18,36
Oklahoma City Thunder,OKC,Seattle SuperSonics,1992,2,B. Kloppenburg,kloppbo99c,2,2,4
Oklahoma City Thunder,OKC,Seattle SuperSonics,1992,3,G. Karl,karlge01c,27,15,42
Oklahoma City Thunder,OKC,Seattle SuperSonics,1993,1,G. Karl,karlge01c,55,27,82
Oklahoma City Thunder,OKC,Seattle SuperSonics,1994,1,G. Karl,karlge01c,63,19,82
Oklahoma City Thunder,OKC,Seattle SuperSonics,1995,1,G. Karl,karlge01c,57,25,82
Oklahoma City Thunder,OKC,Seattle SuperSonics,1996,1,G. Karl,karlge01c,64,18,82
Oklahoma City Thunder,OKC,Seattle SuperSonics,1997,1,G. Karl,karlge01c,57,25,82
Oklahoma City Thunder,OKC,Seattle SuperSonics,1998,1,G. Karl,karlge01c,61,21,82
Oklahoma City Thunder,OKC,Seattle SuperSonics,1999,1,P. Westphal,westppa01c,25,25,50
Oklahoma City Thunder,OKC,Seattle SuperSonics,2000,1,P. Westphal,westppa01c,45,37,82
Oklahoma City Thunder,OKC,Seattle SuperSonics,2001,1,P. Westphal,westppa01c,6,9,15
Oklahoma City Thunder,OKC,Seattle SuperSonics,2001,2,N. McMillan,mcmilna01c,38,29,67
Oklahoma City Thunder,OKC,Seattle SuperSonics,2002,1,N. McMillan,mcmilna01c,45,37,82
Oklahoma City Thunder,OKC,Seattle SuperSonics,2003,1,N. McMillan,mcmilna01c,40,42,82
Oklahoma City Thunder,OKC,Seattle SuperSonics,2004,1,N. McMillan,mcmilna01c,37,45,82
Oklahoma City Thunder,OKC,Seattle SuperSonics,2005,1,N. McMillan,mcmilna01c,52,30,82
Oklahoma City Thunder,OKC,Seattle SuperSonics,2006,1,B. Weiss,weissbo01c,13,17,30
Oklahoma City Thunder,OKC,Seattle SuperSonics,2006,2,B. Hill,hillbo99c,22,30,52
Oklahoma City Thunder,OKC,Seattle SuperSonics,2007,1,B. Hill,hillbo99c,31,51,82
Oklahoma City Thunder,OKC,Seattle SuperSonics,2008,1,P. Carlesimo,carlepj99c,20,62,82
Oklahoma City Thunder,OKC,Oklahoma City Thunder,2009,1,P. Carlesimo,carlepj99c,1,12,13
Oklahoma City Thunder,OKC,Oklahoma City Thunder,2009,2,S. Brooks,brooksc01c,22,47,69
Oklahoma City Thunder,OKC,Oklahoma City Thunder,2010,1,S. Brooks,brooksc01c,50,32,82
Oklahoma City Thunder,OKC,Oklahoma City Thunder,2011,1,S. Brooks,brooksc01c,55,27,82
Oklahoma City Thunder,OKC,Oklahoma City Thunder,2012,1,S. Brooks,brooksc01c,47,19,66
Oklahoma City Thunder,OKC,Oklahoma City Thunder,2013,1,S. Brooks,brooksc01c,60,22,82
Oklahoma City Thunder,OKC,Oklahoma City Thunder,2014,1,S. Brooks,brooksc01c,59,23,82
Oklahoma City Thunder,OKC,Oklahoma City Thunder,2015,1,S. Brooks,brooksc01c,45,37,82
Oklahoma City Thunder,OKC,Oklahoma City Thunder,2016,1,B. Donovan,donovbi99c,55,27,82
Oklahoma City Thunder,OKC,Oklahoma City Thunder,2017,1,B. Donovan,donovbi99c,47,35,82
Oklahoma City Thunder,OKC,Oklahoma City Thunder,2018,1,B. Donovan,donovbi99c,48,34,82
Oklahoma City Thunder,OKC,Oklahoma City Thunder,2019,1,B. Donovan,donovbi99c,49,33,82
Oklahoma City Thunder,OKC,Oklahoma City Thunder,2020,1,B. Donovan,donovbi99c,40,24,64
Orlando Magic,ORL,Orlando Magic,1990,1,M. Guokas,guokama02c,18,64,82
Orlando Magic,ORL,Orlando Magic,1991,1,M. Guokas,guokama02c,31,51,82
Orlando Magic,ORL,Orlando Magic,1992,1,M. Guokas,guokama02c,21,61,82
Orlando Magic,ORL,Orlando Magic,1993,1,M. Guokas,guokama02c,41,41,82
Orlando Magic,ORL,Orlando Magic,1994,1,B. Hill,hillbr99c,50,32,82
Orlando Magic,ORL,Orlando Magic,1995,1,B. Hill,hillbr99c,57,25,82
Orlando Magic,ORL,Orlando Magic,1996,1,B. Hill,hillbr99c,60,22,82
Orlando Magic,ORL,Orlando Magic,1997,1,B. Hill,hillbr99c,24,25,49
Orlando Magic,ORL,Orlando Magic,1997,2,R. Adubato,adubari99c,21,12,33
Orlando Magic,ORL,Orlando Magic,1998,1,C. Daly,dalych99c,41,41,82
Orlando Magic,ORL,Orlando Magic,1999,1,C. Daly,dalych99c,33,17,50
Orlando Magic,ORL,Orlando Magic,2000,1,D. Rivers,riverdo01c,41,41,82
Orlando Magic,ORL,Orlando Magic,2001,1,D. Rivers,riverdo01c,43,39,82
Orlando Magic,ORL,Orlando Magic,2002,1,D. Rivers,riverdo01c,44,38,82
Orlando Magic,ORL,Orlando Magic,2003,1,D. Rivers,riverdo01c,42,40,82
Orlando Magic,ORL,Orlando Magic,2004,1,D. Rivers,riverdo01c,1,10,11
Orlando Magic,ORL,Orlando Magic,2004,2,J. Davis,davisjo01c,20,51,71
Orlando Magic,ORL,Orlando Magic,2005,1,J. Davis,davisjo01c,31,33,64
Orlando Magic,ORL,Orlando Magic,2005,2,C. Jent,jentch01c,5,13,18
Orlando Magic,ORL,Orlando Magic,2006,1,B. Hill,hillbr99c,36,46,82
Orlando Magic,ORL,Orlando Magic,2007,1,B. Hill,hillbr99c,40,42,82
Orlando Magic,ORL,Orlando Magic,2008,1,S. Van Gundy,vangust99c,52,30,82
Orlando Magic,ORL,Orlando Magic,2009,1,S. Van Gundy,vangust99c,59,23,82
Orlando Magic,ORL,Orlando Magic,2010,1,S. Van Gundy,vangust99c,59,23,82
Orlando Magic,ORL,Orlando Magic,2011,1,S. Van Gundy,vangust99c,52,30,82
Orlando Magic,ORL,Orlando Magic,2012,1,S. Van Gundy,vangust99c,37,29,66
Orlando Magic,ORL,Orlando Magic,2013,1,J. Vaughn,vaughja01c,20,62,82
Orlando Magic,ORL,Orlando Magic,2014,1,J. Vaughn,vaughja01c,23,59,82
Orlando Magic,ORL,Orlando Magic,2015,1,J. Vaughn,vaughja01c,15,37,52
Orlando Magic,ORL,Orlando Magic,2015,2,J. Borrego,borreja99c,10,20,30
Orlando Magic,ORL,Orlando Magic,2016,1,S. Skiles,skilesc01c,35,47,82
Orlando Magic,ORL,Orlando Magic,2017,1,F. Vogel,vogelfr99c,29,53,82
Orlando Magic,ORL,Orlando Magic,2018,1,F. Vogel,vogelfr99c,25,57,82
Orlando Magic,ORL,Orlando Magic,2019,1,S. Clifford,cliffst99c,42,40,82
Orlando Magic,ORL,Orlando Magic,2020,1,S. Clifford,cliffst99c,30,35,65
Philadelphia 76ers,PHI,Syracuse Nationals,1950,1,A. Cervi,cervial01c,51,13,64
Philadelphia 76ers,PHI,Syracuse Nationals,1951,1,A. Cervi,cervial01c,32,34,66
Philadelphia 76ers,PHI,Syracuse Nationals,1952,1,A. Cervi,cervial01c,40,26,66
Philadelphia 76ers,PHI,Syracuse Nationals,1953,1,A. Cervi,cervial01c,47,24,71
Philadelphia 76ers,PHI,Syracuse Nationals,1954,1,A. Cervi,cervial01c,42,30,72
Philadelphia 76ers,PHI,Syracuse Nationals,1955,1,A. Cervi,cervial01c,43,29,72
Philadelphia 76ers,PHI,Syracuse Nationals,1956,1,A. Cervi,cervial01c,35,37,72
Philadelphia 76ers,PHI,Syracuse Nationals,1957,1,A. Cervi,cervial01c,4,8,12
Philadelphia 76ers,PHI,Syracuse Nationals,1957,2,P. Seymour,seymopa01c,34,26,60
Philadelphia 76ers,PHI,Syracuse Nationals,1958,1,P. Seymour,seymopa01c,41,31,72
Philadelphia 76ers,PHI,Syracuse Nationals,1959,1,P. Seymour,seymopa01c,35,37,72
Philadelphia 76ers,PHI,Syracuse Nationals,1960,1,P. Seymour,seymopa01c,45,30,75
Philadelphia 76ers,PHI,Syracuse Nationals,1961,1,A. Hannum,hannual01c,38,41,79
Philadelphia 76ers,PHI,Syracuse Nationals,1962,1,A. Hannum,hannual01c,41,39,80
Philadelphia 76ers,PHI,Syracuse Nationals,1963,1,A. Hannum,hannual01c,48,32,80
Philadelphia 76ers,PHI,Philadelphia 76ers,1964,1,D. Schayes,schaydo01c,34,46,80
Philadelphia 76ers,PHI,Philadelphia 76ers,1965,1,D. Schayes,schaydo01c,40,40,80
Philadelphia 76ers,PHI,Philadelphia 76ers,1966,1,D. Schayes,schaydo01c,55,25,80
Philadelphia 76ers,PHI,Philadelphia 76ers,1967,1,A. Hannum,hannual01c,68,13,81
Philadelphia 76ers,PHI,Philadelphia 76ers,1968,1,A. Hannum,hannual01c,62,20,82
Philadelphia 76ers,PHI,Philadelphia 76ers,1969,1,J. Ramsay,ramsaja99c,55,27,82
Philadelphia 76ers,PHI,Philadelphia 76ers,1970,1,J. Ramsay,ramsaja99c,42,40,82
Philadelphia 76ers,PHI,Philadelphia 76ers,1971,1,J. Ramsay,ramsaja99c,47,35,82
Philadelphia 76ers,PHI,Philadelphia 76ers,1972,1,J. Ramsay,ramsaja99c,30,52,82
Philadelphia 76ers,PHI,Philadelphia 76ers,1973,1,R. Rubin,rubinro99c,4,47,51
Philadelphia 76ers,PHI,Philadelphia 76ers,1973,2,K. Loughery,loughke01c,5,26,31
Philadelphia 76ers,PHI,Philadelphia 76ers,1974,1,G. Shue,shuege01c,25,57,82
Philadelphia 76ers,PHI,Philadelphia 76ers,1975,1,G. Shue,shuege01c,34,48,82
Philadelphia 76ers,PHI,Philadelphia 76ers,1976,1,G. Shue,shuege01c,46,36,82
Philadelphia 76ers,PHI,Philadelphia 76ers,1977,1,G. Shue,shuege01c,50,32,82
Philadelphia 76ers,PHI,Philadelphia 76ers,1978,1,G. Shue,shuege01c,2,4,6
Philadelphia 76ers,PHI,Philadelphia 76ers,1978,2,B. Cunningham,cunnibi01c,53,23,76
Philadelphia 76ers,PHI,Philadelphia 76ers,1979,1,B. Cunningham,cunnibi01c,47,35,82
Philadelphia 76ers,PHI,Philadelphia 76ers,1980,1,B. Cunningham,cunnibi01c,59,23,82
Philadelphia 76ers,PHI,Philadelphia 76ers,1981,1,B. Cunningham,cunnibi01c,62,20,82
Philadelphia 76ers,PHI,Philadelphia 76ers,1982,1,B. Cunningham,cunnibi01c,58,24,82
Philadelphia 76ers,PHI,Philadelphia 76ers,1983,1,B. Cunningham,cunnibi01c,65,17,82
Philadelphia 76ers,PHI,Philadelphia 76ers,1984,1,B. Cunningham,cunnibi01c,52,30,82
Philadelphia 76ers,PHI,Philadelphia 76ers,1985,1,B. Cunningham,cunnibi01c,58,24,82
Philadelphia 76ers,PHI,Philadelphia 76ers,1986,1,M. Guokas,guokama02c,54,28,82
Philadelphia 76ers,PHI,Philadelphia 76ers,1987,1,M. Guokas,guokama02c,45,37,82
Philadelphia 76ers,PHI,Philadelphia 76ers,1988,1,M. Guokas,guokama02c,20,23,43
Philadelphia 76ers,PHI,Philadelphia 76ers,1988,2,J. Lynam,lynamji99c,16,23,39
Philadelphia 76ers,PHI,Philadelphia 76ers,1989,1,J. Lynam,lynamji99c,46,36,82
Philadelphia 76ers,PHI,Philadelphia 76ers,1990,1,J. Lynam,lynamji99c,53,29,82
Philadelphia 76ers,PHI,Philadelphia 76ers,1991,1,J. Lynam,lynamji99c,44,38,82
Philadelphia 76ers,PHI,Philadelphia 76ers,1992,1,J. Lynam,lynamji99c,35,47,82
Philadelphia 76ers,PHI,Philadelphia 76ers,1993,1,D. Moe,moedo01c,19,37,56
Philadelphia 76ers,PHI,Philadelphia 76ers,1993,2,F. Carter,cartefr01c,7,19,26
Philadelphia 76ers,PHI,Philadelphia 76ers,1994,1,F. Carter,cartefr01c,25,57,82
Philadelphia 76ers,PHI,Philadelphia 76ers,1995,1,J. Lucas,lucasjo01c,24,58,82
Philadelphia 76ers,PHI,Philadelphia 76ers,1996,1,J. Lucas,lucasjo01c,18,64,82
Philadelphia 76ers,PHI,Philadelphia 76ers,1997,1,J. Davis,davisjo01c,22,60,82
Philadelphia 76ers,PHI,Philadelphia 76ers,1998,1,L. Brown,brownla01c,31,51,82
Philadelphia 76ers,PHI,Philadelphia 76ers,1999,1,L. Brown,brownla01c,28,22,50
Philadelphia 76ers,PHI,Philadelphia 76ers,2000,1,L. Brown,brownla01c,49,33,82
Philadelphia 76ers,PHI,Philadelphia 76ers,2001,1,L. Brown,brownla01c,56,26,82
Philadelphia 76ers,PHI,Philadelphia 76ers,2002,1,L. Brown,brownla01c,43,39,82
Philadelphia 76ers,PHI,Philadelphia 76ers,2003,1,L. Brown,brownla01c,48,34,82
Philadelphia 76ers,PHI,Philadelphia 76ers,2004,1,R. Ayers,ayersra99c,21,31,52
Philadelphia 76ers,PHI,Philadelphia 76ers,2004,2,C. Ford,fordch01c,12,18,30
Philadelphia 76ers,PHI,Philadelphia 76ers,2005,1,J. O'Brien,obrieji99c,43,39,82
Philadelphia 76ers,PHI,Philadelphia 76ers,2006,1,M. Cheeks,cheekma01c,38,44,82
Philadelphia 76ers,PHI,Philadelphia 76ers,2007,1,M. Cheeks,cheekma01c,35,47,82
Philadelphia 76ers,PHI,Philadelphia 76ers,2008,1,M. Cheeks,cheekma01c,40,42,82
Philadelphia 76ers,PHI,Philadelphia 76ers,2009,1,M. Cheeks,cheekma01c,9,14,23
Philadelphia 76ers,PHI,Philadelphia 76ers,2009,2,T. DiLeo,dileoto99c,32,27,59
Philadelphia 76ers,PHI,Philadelphia 76ers,2010,1,E. Jordan,jordaed01c,27,55,82
Philadelphia 76ers,PHI,Philadelphia 76ers,2011,1,D. Collins,collido01c,41,41,82
Philadelphia 76ers,PHI,Philadelphia 76ers,2012,1,D. Collins,collido01c,35,31,66
Philadelphia 76ers,PHI,Philadelphia 76ers,2013,1,D. Collins,collido01c,34,48,82
Philadelphia 76ers,PHI,Philadelphia 76ers,2014,1,B. Brown,brownbr99c,19,63,82
Philadelphia 76ers,PHI,Philadelphia 76ers,2015,1,B. Brown,brownbr99c,18,64,82
Philadelphia 76ers,PHI,Philadelphia 76ers,2016,1,B. Brown,brownbr99c,10,72,82
Philadelphia 76ers,PHI,Philadelphia 76ers,2017,1,B. Brown,brownbr99c,28,54,82
Philadelphia 76ers,PHI,Philadelphia 76ers,2018,1,B. Brown,brownbr99c,52,30,82
Philadelphia 76ers,PHI,Philadelphia 76ers,2019,1,B. Brown,brownbr99c,51,31,82
Philadelphia 76ers,PHI,Philadelphia 76ers,2020,1,B. Brown,brownbr99c,39,26,65
Phoenix Suns,PHO,Phoenix Suns,1969,1,R. Kerr,kerrre01c,16,66,82
Phoenix Suns,PHO,Phoenix Suns,1970,1,R. Kerr,kerrre01c,15,23,38
Phoenix Suns,PHO,Phoenix Suns,1970,2,J. Colangelo,colanje99c,24,20,44
Phoenix Suns,PHO,Phoenix Suns,1971,1,C. Fitzsimmons,fitzsco99c,48,34,82
Phoenix Suns,PHO,Phoenix Suns,1972,1,C. Fitzsimmons,fitzsco99c,49,33,82
Phoenix Suns,PHO,Phoenix Suns,1973,1,B. van Breda Kolff,vanbrbu01c,3,4,7
Phoenix Suns,PHO,Phoenix Suns,1973,2,J. Colangelo,colanje99c,35,40,75
Phoenix Suns,PHO,Phoenix Suns,1974,1,J. MacLeod,maclejo99c,30,52,82
Phoenix Suns,PHO,Phoenix Suns,1975,1,J. MacLeod,maclejo99c,32,50,82
Phoenix Suns,PHO,Phoenix Suns,1976,1,J. MacLeod,maclejo99c,42,40,82
Phoenix Suns,PHO,Phoenix Suns,1977,1,J. MacLeod,maclejo99c,34,48,82
Phoenix Suns,PHO,Phoenix Suns,1978,1,J. MacLeod,maclejo99c,49,33,82
Phoenix Suns,PHO,Phoenix Suns,1979,1,J. MacLeod,maclejo99c,50,32,82
Phoenix Suns,PHO,Phoenix Suns,1980,1,J. MacLeod,maclejo99c,55,27,82
Phoenix Suns,PHO,Phoenix Suns,1981,1,J. MacLeod,maclejo99c,57,25,82
Phoenix Suns,PHO,Phoenix Suns,1982,1,J. MacLeod,maclejo99c,46,36,82
Phoenix Suns,PHO,Phoenix Suns,1983,1,J. MacLeod,maclejo99c,53,29,82
Phoenix Suns,PHO,Phoenix Suns,1984,1,J. MacLeod,maclejo99c,41,41,82
Phoenix Suns,PHO,Phoenix Suns,1985,1,J. MacLeod,maclejo99c,36,46,82
Phoenix Suns,PHO,Phoenix Suns,1986,1,J. MacLeod,maclejo99c,32,50,82
Phoenix Suns,PHO,Phoenix Suns,1987,1,J. MacLeod,maclejo99c,22,34,56
Phoenix Suns,PHO,Phoenix Suns,1987,2,D. Van Arsdale,vanardi01c,14,12,26
Phoenix Suns,PHO,Phoenix Suns,1988,1,J. Wetzel,wetzejo01c,28,54,82
Phoenix Suns,PHO,Phoenix Suns,1989,1,C. Fitzsimmons,fitzsco99c,55,27,82
Phoenix Suns,PHO,Phoenix Suns,1990,1,C. Fitzsimmons,fitzsco99c,54,28,82
Phoenix Suns,PHO,Phoenix Suns,1991,1,C. Fitzsimmons,fitzsco99c,55,27,82
Phoenix Suns,PHO,Phoenix Suns,1992,1,C. Fitzsimmons,fitzsco99c,53,29,82
Phoenix Suns,PHO,Phoenix Suns,1993,1,P. Westphal,westppa01c,62,20,82
Phoenix Suns,PHO,Phoenix Suns,1994,1,P. Westphal,westppa01c,56,26,82
Phoenix Suns,PHO,Phoenix Suns,1995,1,P. Westphal,westppa01c,59,23,82
Phoenix Suns,PHO,Phoenix Suns,1996,1,P. Westphal,westppa01c,14,19,33
Phoenix Suns,PHO,Phoenix Suns,1996,2,C. Fitzsimmons,fitzsco99c,27,22,49
Phoenix Suns,PHO,Phoenix Suns,1997,1,C. Fitzsimmons,fitzsco99c,0,8,8
Phoenix Suns,PHO,Phoenix Suns,1997,2,D. Ainge,aingeda01c,40,34,74
Phoenix Suns,PHO,Phoenix Suns,1998,1,D. Ainge,aingeda01c,56,26,82
Phoenix Suns,PHO,Phoenix Suns,1999,1,D. Ainge,aingeda01c,27,23,50
Phoenix Suns,PHO,Phoenix Suns,2000,1,D. Ainge,aingeda01c,13,7,20
Phoenix Suns,PHO,Phoenix Suns,2000,2,S. Skiles,skilesc01c,40,22,62
Phoenix Suns,PHO,Phoenix Suns,2001,1,S. Skiles,skilesc01c,51,31,82
Phoenix Suns,PHO,Phoenix Suns,2002,1,S. Skiles,skilesc01c,25,26,51
Phoenix Suns,PHO,Phoenix Suns,2002,2,F. Johnson,johnsfr01c,11,20,31
Phoenix Suns,PHO,Phoenix Suns,2003,1,F. Johnson,johnsfr01c,44,38,82
Phoenix Suns,PHO,Phoenix Suns,2004,1,F. Johnson,johnsfr01c,8,13,21
Phoenix Suns,PHO,Phoenix Suns,2004,2,M. D'Antoni,dantomi01c,21,40,61
Phoenix Suns,PHO,Phoenix Suns,2005,1,M. D'Antoni,dantomi01c,62,20,82
Phoenix Suns,PHO,Phoenix Suns,2006,1,M. D'Antoni,dantomi01c,54,28,82
Phoenix Suns,PHO,Phoenix Suns,2007,1,M. D'Antoni,dantomi01c,61,21,82
Phoenix Suns,PHO,Phoenix Suns,2008,1,M. D'Antoni,dantomi01c,55,27,82
Phoenix Suns,PHO,Phoenix Suns,2009,1,T. Porter,portete01c,28,23,51
Phoenix Suns,PHO,Phoenix Suns,2009,2,A. Gentry,gentral99c,18,13,31
Phoenix Suns,PHO,Phoenix Suns,2010,1,A. Gentry,gentral99c,54,28,82
Phoenix Suns,PHO,Phoenix Suns,2011,1,A. Gentry,gentral99c,40,42,82
Phoenix Suns,PHO,Phoenix Suns,2012,1,A. Gentry,gentral99c,33,33,66
Phoenix Suns,PHO,Phoenix Suns,2013,1,A. Gentry,gentral99c,13,28,41
Phoenix Suns,PHO,Phoenix Suns,2013,2,L. Hunter,hunteli01c,12,29,41
Phoenix Suns,PHO,Phoenix Suns,2014,1,J. Hornacek,hornaje01c,48,34,82
Phoenix Suns,PHO,Phoenix Suns,2015,1,J. Hornacek,hornaje01c,39,43,82
Phoenix Suns,PHO,Phoenix Suns,2016,1,J. Hornacek,hornaje01c,14,35,49
Phoenix Suns,PHO,Phoenix Suns,2016,2,E. Watson,watsoea01c,9,24,33
Phoenix Suns,PHO,Phoenix Suns,2017,1,E. Watson,watsoea01c,24,58,82
Phoenix Suns,PHO,Phoenix Suns,2018,1,E. Watson,watsoea01c,0,3,3
Phoenix Suns,PHO,Phoenix Suns,2018,2,J. Triano,trianja99c,21,58,79
Phoenix Suns,PHO,Phoenix Suns,2019,1,I. Kokoskov,kokosig01c,19,63,82
Phoenix Suns,PHO,Phoenix Suns,2020,1,M. Williams,willimo01c,26,39,65
Portland Trail Blazers,POR,Portland Trail Blazers,1971,1,R. Todd,toddro99c,29,53,82
Portland Trail Blazers,POR,Portland Trail Blazers,1972,1,R. Todd,toddro99c,12,44,56
Portland Trail Blazers,POR,Portland Trail Blazers,1972,2,S. Inman,inmanst99c,6,20,26
Portland Trail Blazers,POR,Portland Trail Blazers,1973,1,J. McCloskey,mccloja01d,21,61,82
Portland Trail Blazers,POR,Portland Trail Blazers,1974,1,J. McCloskey,mccloja01d,27,55,82
Portland Trail Blazers,POR,Portland Trail Blazers,1975,1,L. Wilkens,wilkele01c,38,44,82
Portland Trail Blazers,POR,Portland Trail Blazers,1976,1,L. Wilkens,wilkele01c,37,45,82
Portland Trail Blazers,POR,Portland Trail Blazers,1977,1,J. Ramsay,ramsaja99c,49,33,82
Portland Trail Blazers,POR,Portland Trail Blazers,1978,1,J. Ramsay,ramsaja99c,58,24,82
Portland Trail Blazers,POR,Portland Trail Blazers,1979,1,J. Ramsay,ramsaja99c,45,37,82
Portland Trail Blazers,POR,Portland Trail Blazers,1980,1,J. Ramsay,ramsaja99c,38,44,82
Portland Trail Blazers,POR,Portland Trail Blazers,1981,1,J. Ramsay,ramsaja99c,45,37,82
Portland Trail Blazers,POR,Portland Trail Blazers,1982,1,J. Ramsay,ramsaja99c,42,40,82
Portland Trail Blazers,POR,Portland Trail Blazers,1983,1,J. Ramsay,ramsaja99c,46,36,82
Portland Trail Blazers,POR,Portland Trail Blazers,1984,1,J. Ramsay,ramsaja99c,48,34,82
Portland Trail Blazers,POR,Portland Trail Blazers,1985,1,J. Ramsay,ramsaja99c,42,40,82
Portland Trail Blazers,POR,Portland Trail Blazers,1986,1,J. Ramsay,ramsaja99c,40,42,82
Portland Trail Blazers,POR,Portland Trail Blazers,1987,1,M. Schuler,schulmi99c,49,33,82
Portland Trail Blazers,POR,Portland Trail Blazers,1988,1,M. Schuler,schulmi99c,53,29,82
Portland Trail Blazers,POR,Portland Trail Blazers,1989,1,M. Schuler,schulmi99c,25,22,47
Portland Trail Blazers,POR,Portland Trail Blazers,1989,2,R. Adelman,adelmri01c,14,21,35
Portland Trail Blazers,POR,Portland Trail Blazers,1990,1,R. Adelman,adelmri01c,59,23,82
Portland Trail Blazers,POR,Portland Trail Blazers,1991,1,R. Adelman,adelmri01c,63,19,82
Portland Trail Blazers,POR,Portland Trail Blazers,1992,1,R. Adelman,adelmri01c,57,25,82
Portland Trail Blazers,POR,Portland Trail Blazers,1993,1,R. Adelman,adelmri01c,51,31,82
Portland Trail Blazers,POR,Portland Trail Blazers,1994,1,R. Adelman,adelmri01c,47,35,82
Portland Trail Blazers,POR,Portland Trail Blazers,1995,1,P. Carlesimo,carlepj99c,44,38,82
Portland Trail Blazers,POR,Portland Trail Blazers,1996,1,P. Carlesimo,carlepj99c,44,38,82
Portland Trail Blazers,POR,Portland Trail Blazers,1997,1,P. Carlesimo,carlepj99c,49,33,82
Portland Trail Blazers,POR,Portland Trail Blazers,1998,1,M. Dunleavy,dunlemi01c,46,36,82
Portland Trail Blazers,POR,Portland Trail Blazers,1999,1,M. Dunleavy,dunlemi01c,35,15,50
Portland Trail Blazers,POR,Portland Trail Blazers,2000,1,M. Dunleavy,dunlemi01c,59,23,82
Portland Trail Blazers,POR,Portland Trail Blazers,2001,1,M. Dunleavy,dunlemi01c,50,32,82
Portland Trail Blazers,POR,Portland Trail Blazers,2002,1,M. Cheeks,cheekma01c,49,33,82
Portland Trail Blazers,POR,Portland Trail Blazers,2003,1,M. Cheeks,cheekma01c,50,32,82
Portland Trail Blazers,POR,Portland Trail Blazers,2004,1,M. Cheeks,cheekma01c,41,41,82
Portland Trail Blazers,POR,Portland Trail Blazers,2005,1,M. Cheeks,cheekma01c,22,33,55
Portland Trail Blazers,POR,Portland Trail Blazers,2005,2,K. Pritchard,pritcke01c,5,22,27
Portland Trail Blazers,POR,Portland Trail Blazers,2006,1,N. McMillan,mcmilna01c,21,61,82
Portland Trail Blazers,POR,Portland Trail Blazers,2007,1,N. McMillan,mcmilna01c,32,50,82
Portland Trail Blazers,POR,Portland Trail Blazers,2008,1,N. McMillan,mcmilna01c,41,41,82
Portland Trail Blazers,POR,Portland Trail Blazers,2009,1,N. McMillan,mcmilna01c,54,28,82
Portland Trail Blazers,POR,Portland Trail Blazers,2010,1,N. McMillan,mcmilna01c,50,32,82
Portland Trail Blazers,POR,Portland Trail Blazers,2011,1,N. McMillan,mcmilna01c,48,34,82
Portland Trail Blazers,POR,Portland Trail Blazers,2012,1,N. McMillan,mcmilna01c,20,23,43
Portland Trail Blazers,POR,Portland Trail Blazers,2012,2,K. Canales,canalka99c,8,15,23
Portland Trail Blazers,POR,Portland Trail Blazers,2013,1,T. Stotts,stottte99c,33,49,82
Portland Trail Blazers,POR,Portland Trail Blazers,2014,1,T. Stotts,stottte99c,54,28,82
Portland Trail Blazers,POR,Portland Trail Blazers,2015,1,T. Stotts,stottte99c,51,31,82
Portland Trail Blazers,POR,Portland Trail Blazers,2016,1,T. Stotts,stottte99c,44,38,82
Portland Trail Blazers,POR,Portland Trail Blazers,2017,1,T. Stotts,stottte99c,41,41,82
Portland Trail Blazers,POR,Portland Trail Blazers,2018,1,T. Stotts,stottte99c,49,33,82
Portland Trail Blazers,POR,Portland Trail Blazers,2019,1,T. Stotts,stottte99c,53,29,82
Portland Trail Blazers,POR,Portland Trail Blazers,2020,1,T. Stotts,stottte99c,29,37,66
Sacramento Kings,SAC,Rochester Royals,1949,1,L. Harrison,harrile99c,45,15,60
Sacramento Kings,SAC,Rochester Royals,1950,1,L. Harrison,harrile99c,51,17,68
Sacramento Kings,SAC,Rochester Royals,1951,1,L. Harrison,harrile99c,41,27,68
Sacramento Kings,SAC,Rochester Royals,1952,1,L. Harrison,harrile99c,41,25,66
Sacramento Kings,SAC,Rochester Royals,1953,1,L. Harrison,harrile99c,44,26,70
Sacramento Kings,SAC,Rochester Royals,1954,1,L. Harrison,harrile99c,44,28,72
Sacramento Kings,SAC,Rochester Royals,1955,1,L. Harrison,harrile99c,29,43,72
Sacramento Kings,SAC,Rochester Royals,1956,1,B. Wanzer,wanzebo01c,31,41,72
Sacramento Kings,SAC,Rochester Royals,1957,1,B. Wanzer,wanzebo01c,31,41,72
Sacramento Kings,SAC,Cincinnati Royals,1958,1,B. Wanzer,wanzebo01c,33,39,72
Sacramento Kings,SAC,Cincinnati Royals,1959,1,B. Wanzer,wanzebo01c,3,15,18
Sacramento Kings,SAC,Cincinnati Royals,1959,2,T. Marshall,marshto01c,16,38,54
Sacramento Kings,SAC,Cincinnati Royals,1960,1,T. Marshall,marshto01c,19,56,75
Sacramento Kings,SAC,Cincinnati Royals,1961,1,C. Wolf,wolfch99c,33,46,79
Sacramento Kings,SAC,Cincinnati Royals,1962,1,C. Wolf,wolfch99c,43,37,80
Sacramento Kings,SAC,Cincinnati Royals,1963,1,C. Wolf,wolfch99c,42,38,80
Sacramento Kings,SAC,Cincinnati Royals,1964,1,J. McMahon,mcmahja01c,55,25,80
Sacramento Kings,SAC,Cincinnati Royals,1965,1,J. McMahon,mcmahja01c,48,32,80
Sacramento Kings,SAC,Cincinnati Royals,1966,1,J. McMahon,mcmahja01c,45,35,80
Sacramento Kings,SAC,Cincinnati Royals,1967,1,J. McMahon,mcmahja01c,39,42,81
Sacramento Kings,SAC,Cincinnati Royals,1968,1,E. Jucker,juckeed99c,39,43,82
Sacramento Kings,SAC,Cincinnati Royals,1969,1,E. Jucker,juckeed99c,41,41,82
Sacramento Kings,SAC,Cincinnati Royals,1970,1,B. Cousy,cousybo01c,36,46,82
Sacramento Kings,SAC,Cincinnati Royals,1971,1,B. Cousy,cousybo01c,33,49,82
Sacramento Kings,SAC,Cincinnati Royals,1972,1,B. Cousy,cousybo01c,30,52,82
Sacramento Kings,SAC,Kansas City-Omaha Kings,1973,1,B. Cousy,cousybo01c,36,46,82
Sacramento Kings,SAC,Kansas City-Omaha Kings,1974,1,B. Cousy,cousybo01c,6,14,20
Sacramento Kings,SAC,Kansas City-Omaha Kings,1974,2,D. Young,youngdr99c,0,4,4
Sacramento Kings,SAC,Kansas City-Omaha Kings,1974,3,P. Johnson,johnsph99c,27,31,58
Sacramento Kings,SAC,Kansas City-Omaha Kings,1975,1,P. Johnson,johnsph99c,44,38,82
Sacramento Kings,SAC,Kansas City Kings,1976,1,P. Johnson,johnsph99c,31,51,82
Sacramento Kings,SAC,Kansas City Kings,1977,1,P. Johnson,johnsph99c,40,42,82
Sacramento Kings,SAC,Kansas City Kings,1978,1,P. Johnson,johnsph99c,13,24,37
Sacramento Kings,SAC,Kansas City Kings,1978,2,L. Staverman,stavela01c,18,27,45
Sacramento Kings,SAC,Kansas City Kings,1979,1,C. Fitzsimmons,fitzsco99c,48,34,82
Sacramento Kings,SAC,Kansas City Kings,1980,1,C. Fitzsimmons,fitzsco99c,47,35,82
Sacramento Kings,SAC,Kansas City Kings,1981,1,C. Fitzsimmons,fitzsco99c,40,42,82
Sacramento Kings,SAC,Kansas City Kings,1982,1,C. Fitzsimmons,fitzsco99c,30,52,82
Sacramento Kings,SAC,Kansas City Kings,1983,1,C. Fitzsimmons,fitzsco99c,45,37,82
Sacramento Kings,SAC,Kansas City Kings,1984,1,C. Fitzsimmons,fitzsco99c,38,44,82
Sacramento Kings,SAC,Kansas City Kings,1985,1,J. McKinney,mckinja99c,1,8,9
Sacramento Kings,SAC,Kansas City Kings,1985,2,P. Johnson,johnsph99c,30,43,73
Sacramento Kings,SAC,Sacramento Kings,1986,1,P. Johnson,johnsph99c,37,45,82
Sacramento Kings,SAC,Sacramento Kings,1987,1,P. Johnson,johnsph99c,14,32,46
Sacramento Kings,SAC,Sacramento Kings,1987,2,J. Reynolds,reynoje99c,15,21,36
Sacramento Kings,SAC,Sacramento Kings,1988,1,B. Russell,russebi01c,17,41,58
Sacramento Kings,SAC,Sacramento Kings,1988,2,J. Reynolds,reynoje99c,7,17,24
Sacramento Kings,SAC,Sacramento Kings,1989,1,J. Reynolds,reynoje99c,27,55,82
Sacramento Kings,SAC,Sacramento Kings,1990,1,J. Reynolds,reynoje99c,7,21,28
Sacramento Kings,SAC,Sacramento Kings,1990,2,D. Motta,mottadi99c,16,38,54
Sacramento Kings,SAC,Sacramento Kings,1991,1,D. Motta,mottadi99c,25,57,82
Sacramento Kings,SAC,Sacramento Kings,1992,1,D. Motta,mottadi99c,7,18,25
Sacramento Kings,SAC,Sacramento Kings,1992,2,R. Hughes,hughere99c,22,35,57
Sacramento Kings,SAC,Sacramento Kings,1993,1,G. St. Jean,stjeaga99c,25,57,82
Sacramento Kings,SAC,Sacramento Kings,1994,1,G. St. Jean,stjeaga99c,28,54,82
Sacramento Kings,SAC,Sacramento Kings,1995,1,G. St. Jean,stjeaga99c,39,43,82
Sacramento Kings,SAC,Sacramento Kings,1996,1,G. St. Jean,stjeaga99c,39,43,82
Sacramento Kings,SAC,Sacramento Kings,1997,1,G. St. Jean,stjeaga99c,28,39,67
Sacramento Kings,SAC,Sacramento Kings,1997,2,E. Jordan,jordaed01c,6,9,15
Sacramento Kings,SAC,Sacramento Kings,1998,1,E. Jordan,jordaed01c,27,55,82
Sacramento Kings,SAC,Sacramento Kings,1999,1,R. Adelman,adelmri01c,27,23,50
Sacramento Kings,SAC,Sacramento Kings,2000,1,R. Adelman,adelmri01c,44,38,82
Sacramento Kings,SAC,Sacramento Kings,2001,1,R. Adelman,adelmri01c,55,27,82
Sacramento Kings,SAC,Sacramento Kings,2002,1,R. Adelman,adelmri01c,61,21,82
Sacramento Kings,SAC,Sacramento Kings,2003,1,R. Adelman,adelmri01c,59,23,82
Sacramento Kings,SAC,Sacramento Kings,2004,1,R. Adelman,adelmri01c,55,27,82
Sacramento Kings,SAC,Sacramento Kings,2005,1,R. Adelman,adelmri01c,50,32,82
Sacramento Kings,SAC,Sacramento Kings,2006,1,R. Adelman,adelmri01c,44,38,82
Sacramento Kings,SAC,Sacramento Kings,2007,1,E. Musselman,musseer99c,33,49,82
Sacramento Kings,SAC,Sacramento Kings,2008,1,R. Theus,theusre01c,38,44,82
Sacramento Kings,SAC,Sacramento Kings,2009,1,R. Theus,theusre01c,6,18,24
Sacramento Kings,SAC,Sacramento Kings,2009,2,K. Natt,nattke01c,11,47,58
Sacramento Kings,SAC,Sacramento Kings,2010,1,P. Westphal,westppa01c,25,57,82
Sacramento Kings,SAC,Sacramento Kings,2011,1,P. Westphal,westppa01c,24,58,82
Sacramento Kings,SAC,Sacramento Kings,2012,1,P. Westphal,westppa01c,2,5,7
Sacramento Kings,SAC,Sacramento Kings,2012,2,K. Smart,smartke01c,20,39,59
Sacramento Kings,SAC,Sacramento Kings,2013,1,K. Smart,smartke01c,28,54,82
Sacramento Kings,SAC,Sacramento Kings,2014,1,M. Malone,malonmi99c,28,54,82
Sacramento Kings,SAC,Sacramento Kings,2015,1,M. Malone,malonmi99c,11,13,24
Sacramento Kings,SAC,Sacramento Kings,2015,2,T. Corbin,corbity01c,7,21,28
Sacramento Kings,SAC,Sacramento Kings,2015,3,G. Karl,karlge01c,11,19,30
Sacramento Kings,SAC,Sacramento Kings,2016,1,G. Karl,karlge01c,33,49,82
Sacramento Kings,SAC,Sacramento Kings,2017,1,D. Joerger,joergda99c,32,50,82
Sacramento Kings,SAC,Sacramento Kings,2018,1,D. Joerger,joergda99c,27,55,82
Sacramento Kings,SAC,Sacramento Kings,2019,1,D. Joerger,joergda99c,39,43,82
Sacramento Kings,SAC,Sacramento Kings,2020,1,L. Walton,waltolu01c,28,36,64
San Antonio Spurs,SAS,Dallas Chaparrals,1968,1,C. Hagan,hagancl01c,46,32,78
San Antonio Spurs,SAS,Dallas Chaparrals,1969,1,C. Hagan,hagancl01c,41,37,78
San Antonio Spurs,SAS,Dallas Chaparrals,1970,1,C. Hagan,hagancl01c,22,21,43
San Antonio Spurs,SAS,Dallas Chaparrals,1970,2,M. Williams,willima99c,23,18,41
San Antonio Spurs,SAS,Texas Chaparrals,1971,1,M. Williams,willima99c,5,14,19
San Antonio Spurs,SAS,Texas Chaparrals,1971,2,B. Blakeley,blakebi99c,25,40,65
San Antonio Spurs,SAS,Dallas Chaparrals,1972,1,T. Nissalke,nissato99c,42,42,84
San Antonio Spurs,SAS,Dallas Chaparrals,1973,1,B. McCarthy,mccarba99c,24,48,72
San Antonio Spurs,SAS,Dallas Chaparrals,1973,2,D. Brown,brownda99c,4,8,12
San Antonio Spurs,SAS,San Antonio Spurs,1974,1,T. Nissalke,nissato99c,45,39,84
San Antonio Spurs,SAS,San Antonio Spurs,1975,1,T. Nissalke,nissato99c,18,10,28
San Antonio Spurs,SAS,San Antonio Spurs,1975,2,B. Bass,bassbo99c,33,23,56
San Antonio Spurs,SAS,San Antonio Spurs,1976,1,B. Bass,bassbo99c,50,34,84
San Antonio Spurs,SAS,San Antonio Spurs,1977,1,D. Moe,moedo01c,44,38,82
San Antonio Spurs,SAS,San Antonio Spurs,1978,1,D. Moe,moedo01c,52,30,82
San Antonio Spurs,SAS,San Antonio Spurs,1979,1,D. Moe,moedo01c,48,34,82
San Antonio Spurs,SAS,San Antonio Spurs,1980,1,D. Moe,moedo01c,33,33,66
San Antonio Spurs,SAS,San Antonio Spurs,1980,2,B. Bass,bassbo99c,8,8,16
San Antonio Spurs,SAS,San Antonio Spurs,1981,1,S. Albeck,albecst99c,52,30,82
San Antonio Spurs,SAS,San Antonio Spurs,1982,1,S. Albeck,albecst99c,48,34,82
San Antonio Spurs,SAS,San Antonio Spurs,1983,1,S. Albeck,albecst99c,53,29,82
San Antonio Spurs,SAS,San Antonio Spurs,1984,1,M. McHone,mchonmo99c,11,20,31
San Antonio Spurs,SAS,San Antonio Spurs,1984,2,B. Bass,bassbo99c,26,25,51
San Antonio Spurs,SAS,San Antonio Spurs,1985,1,C. Fitzsimmons,fitzsco99c,41,41,82
San Antonio Spurs,SAS,San Antonio Spurs,1986,1,C. Fitzsimmons,fitzsco99c,35,47,82
San Antonio Spurs,SAS,San Antonio Spurs,1987,1,B. Weiss,weissbo01c,28,54,82
San Antonio Spurs,SAS,San Antonio Spurs,1988,1,B. Weiss,weissbo01c,31,51,82
San Antonio Spurs,SAS,San Antonio Spurs,1989,1,L. Brown,brownla01c,21,61,82
San Antonio Spurs,SAS,San Antonio Spurs,1990,1,L. Brown,brownla01c,56,26,82
San Antonio Spurs,SAS,San Antonio Spurs,1991,1,L. Brown,brownla01c,55,27,82
San Antonio Spurs,SAS,San Antonio Spurs,1992,1,L. Brown,brownla01c,21,17,38
San Antonio Spurs,SAS,San Antonio Spurs,1992,2,B. Bass,bassbo99c,26,18,44
San Antonio Spurs,SAS,San Antonio Spurs,1993,1,J. Tarkanian,tarkaje99c,9,11,20
San Antonio Spurs,SAS,San Antonio Spurs,1993,2,R. Hughes,hughere99c,1,0,1
San Antonio Spurs,SAS,San Antonio Spurs,1993,3,J. Lucas,lucasjo01c,39,22,61
San Antonio Spurs,SAS,San Antonio Spurs,1994,1,J. Lucas,lucasjo01c,55,27,82
San Antonio Spurs,SAS,San Antonio Spurs,1995,1,B. Hill,hillbo99c,62,20,82
San Antonio Spurs,SAS,San Antonio Spurs,1996,1,B. Hill,hillbo99c,59,23,82
San Antonio Spurs,SAS,San Antonio Spurs,1997,1,B. Hill,hillbo99c,3,15,18
San Antonio Spurs,SAS,San Antonio Spurs,1997,2,G. Popovich,popovgr99c,17,47,64
San Antonio Spurs,SAS,San Antonio Spurs,1998,1,G. Popovich,popovgr99c,56,26,82
San Antonio Spurs,SAS,San Antonio Spurs,1999,1,G. Popovich,popovgr99c,37,13,50
San Antonio Spurs,SAS,San Antonio Spurs,2000,1,G. Popovich,popovgr99c,53,29,82
San Antonio Spurs,SAS,San Antonio Spurs,2001,1,G. Popovich,popovgr99c,58,24,82
San Antonio Spurs,SAS,San Antonio Spurs,2002,1,G. Popovich,popovgr99c,58,24,82
San Antonio Spurs,SAS,San Antonio Spurs,2003,1,G. Popovich,popovgr99c,60,22,82
San Antonio Spurs,SAS,San Antonio Spurs,2004,1,G. Popovich,popovgr99c,57,25,82
San Antonio Spurs,SAS,San Antonio Spurs,2005,1,G. Popovich,popovgr99c,59,23,82
San Antonio Spurs,SAS,San Antonio Spurs,2006,1,G. Popovich,popovgr99c,63,19,82
San Antonio Spurs,SAS,San Antonio Spurs,2007,1,G. Popovich,popovgr99c,58,24,82
San Antonio Spurs,SAS,San Antonio Spurs,2008,1,G. Popovich,popovgr99c,56,26,82
San Antonio Spurs,SAS,San Antonio Spurs,2009,1,G. Popovich,popovgr99c,54,28,82
San Antonio Spurs,SAS,San Antonio Spurs,2010,1,G. Popovich,popovgr99c,50,32,82
San Antonio Spurs,SAS,San Antonio Spurs,2011,1,G. Popovich,popovgr99c,61,21,82
San Antonio Spurs,SAS,San Antonio Spurs,2012,1,G. Popovich,popovgr99c,50,16,66
San Antonio Spurs,SAS,San Antonio Spurs,2013,1,G. Popovich,popovgr99c,58,24,82
San Antonio Spurs,SAS,San Antonio Spurs,2014,1,G. Popovich,popovgr99c,62,20,82
San Antonio Spurs,SAS,San Antonio Spurs,2015,1,G. Popovich,popovgr99c,55,27,82
San Antonio Spurs,SAS,San Antonio Spurs,2016,1,G. Popovich,popovgr99c,67,15,82
San Antonio Spurs,SAS,San Antonio Spurs,2017,1,G. Popovich,popovgr99c,61,21,82
San Antonio Spurs,SAS,San Antonio Spurs,2018,1,G. Popovich,popovgr99c,47,35,82
San Antonio Spurs,SAS,San Antonio Spurs,2019,1,G. Popovich,popovgr99c,48,34,82
San Antonio Spurs,SAS,San Antonio Spurs,2020,1,G. Popovich,popovgr99c,27,36,63
Toronto Raptors,TOR,Toronto Raptors,1996,1,B. Malone,malonbr99c,21,61,82
Toronto Raptors,TOR,Toronto Raptors,1997,1,D. Walker,walkeda01c,30,52,82
Toronto Raptors,TOR,Toronto Raptors,1998,1,D. Walker,walkeda01c,11,38,49
Toronto Raptors,TOR,Toronto Raptors,1998,2,B. Carter,cartebu01c,5,28,33
Toronto Raptors,TOR,Toronto Raptors,1999,1,B. Carter,cartebu01c,23,27,50
Toronto Raptors,TOR,Toronto Raptors,2000,1,B. Carter,cartebu01c,45,37,82
Toronto Raptors,TOR,Toronto Raptors,2001,1,L. Wilkens,wilkele01c,47,35,82
Toronto Raptors,TOR,Toronto Raptors,2002,1,L. Wilkens,wilkele01c,42,40,82
Toronto Raptors,TOR,Toronto Raptors,2003,1,L. Wilkens,wilkele01c,24,58,82
Toronto Raptors,TOR,Toronto Raptors,2004,1,K. O'Neill,oneilke99c,33,49,82
Toronto Raptors,TOR,Toronto Raptors,2005,1,S. Mitchell,mitchsa01c,33,49,82
Toronto Raptors,TOR,Toronto Raptors,2006,1,S. Mitchell,mitchsa01c,27,55,82
Toronto Raptors,TOR,Toronto Raptors,2007,1,S. Mitchell,mitchsa01c,47,35,82
Toronto Raptors,TOR,Toronto Raptors,2008,1,S. Mitchell,mitchsa01c,41,41,82
Toronto Raptors,TOR,Toronto Raptors,2009,1,S. Mitchell,mitchsa01c,8,9,17
Toronto Raptors,TOR,Toronto Raptors,2009,2,J. Triano,trianja99c,25,40,65
Toronto Raptors,TOR,Toronto Raptors,2010,1,J. Triano,trianja99c,40,42,82
Toronto Raptors,TOR,Toronto Raptors,2011,1,J. Triano,trianja99c,22,60,82
Toronto Raptors,TOR,Toronto Raptors,2012,1,D. Casey,caseydw99c,23,43,66
Toronto Raptors,TOR,Toronto Raptors,2013,1,D. Casey,caseydw99c,34,48,82
Toronto Raptors,TOR,Toronto Raptors,2014,1,D. Casey,caseydw99c,48,34,82
Toronto Raptors,TOR,Toronto Raptors,2015,1,D. Casey,caseydw99c,49,33,82
Toronto Raptors,TOR,Toronto Raptors,2016,1,D. Casey,caseydw99c,56,26,82
Toronto Raptors,TOR,Toronto Raptors,2017,1,D. Casey,caseydw99c,51,31,82
Toronto Raptors,TOR,Toronto Raptors,2018,1,D. Casey,caseydw99c,59,23,82
Toronto Raptors,TOR,Toronto Raptors,2019,1,N. Nurse,nurseni01c,58,24,82
Toronto Raptors,TOR,Toronto Raptors,2020,1,N. Nurse,nurseni01c,46,18,64
Utah Jazz,UTA,New Orleans Jazz,1975,1,S. Robertson,robersc99c,1,14,15
Utah Jazz,UTA,New Orleans Jazz,1975,2,E. Baylor,bayloel01c,0,1,1
Utah Jazz,UTA,New Orleans Jazz,1975,3,B. van Breda Kolff,vanbrbu01c,22,44,66
Utah Jazz,UTA,New Orleans Jazz,1976,1,B. van Breda Kolff,vanbrbu01c,38,44,82
Utah Jazz,UTA,New Orleans Jazz,1977,1,B. van Breda Kolff,vanbrbu01c,14,12,26
Utah Jazz,UTA,New Orleans Jazz,1977,2,E. Baylor,bayloel01c,21,35,56
Utah Jazz,UTA,New Orleans Jazz,1978,1,E. Baylor,bayloel01c,39,43,82
Utah Jazz,UTA,New Orleans Jazz,1979,1,E. Baylor,bayloel01c,26,56,82
Utah Jazz,UTA,Utah Jazz,1980,1,T. Nissalke,nissato99c,24,58,82
Utah Jazz,UTA,Utah Jazz,1981,1,T. Nissalke,nissato99c,28,54,82
Utah Jazz,UTA,Utah Jazz,1982,1,T. Nissalke,nissato99c,8,12,20
Utah Jazz,UTA,Utah Jazz,1982,2,F. Layden,laydefr99c,17,45,62
Utah Jazz,UTA,Utah Jazz,1983,1,F. Layden,laydefr99c,30,52,82
Utah Jazz,UTA,Utah Jazz,1984,1,F. Layden,laydefr99c,45,37,82
Utah Jazz,UTA,Utah Jazz,1985,1,F. Layden,laydefr99c,41,41,82
Utah Jazz,UTA,Utah Jazz,1986,1,F. Layden,laydefr99c,42,40,82
Utah Jazz,UTA,Utah Jazz,1987,1,F. Layden,laydefr99c,44,38,82
Utah Jazz,UTA,Utah Jazz,1988,1,F. Layden,laydefr99c,47,35,82
Utah Jazz,UTA,Utah Jazz,1989,1,F. Layden,laydefr99c,11,6,17
Utah Jazz,UTA,Utah Jazz,1989,2,J. Sloan,sloanje01c,40,25,65
Utah Jazz,UTA,Utah Jazz,1990,1,J. Sloan,sloanje01c,55,27,82
Utah Jazz,UTA,Utah Jazz,1991,1,J. Sloan,sloanje01c,54,28,82
Utah Jazz,UTA,Utah Jazz,1992,1,J. Sloan,sloanje01c,55,27,82
Utah Jazz,UTA,Utah Jazz,1993,1,J. Sloan,sloanje01c,47,35,82
Utah Jazz,UTA,Utah Jazz,1994,1,J. Sloan,sloanje01c,53,29,82
Utah Jazz,UTA,Utah Jazz,1995,1,J. Sloan,sloanje01c,60,22,82
Utah Jazz,UTA,Utah Jazz,1996,1,J. Sloan,sloanje01c,55,27,82
Utah Jazz,UTA,Utah Jazz,1997,1,J. Sloan,sloanje01c,64,18,82
Utah Jazz,UTA,Utah Jazz,1998,1,J. Sloan,sloanje01c,62,20,82
Utah Jazz,UTA,Utah Jazz,1999,1,J. Sloan,sloanje01c,37,13,50
Utah Jazz,UTA,Utah Jazz,2000,1,J. Sloan,sloanje01c,55,27,82
Utah Jazz,UTA,Utah Jazz,2001,1,J. Sloan,sloanje01c,53,29,82
Utah Jazz,UTA,Utah Jazz,2002,1,J. Sloan,sloanje01c,44,38,82
Utah Jazz,UTA,Utah Jazz,2003,1,J. Sloan,sloanje01c,47,35,82
Utah Jazz,UTA,Utah Jazz,2004,1,J. Sloan,sloanje01c,42,40,82
Utah Jazz,UTA,Utah Jazz,2005,1,J. Sloan,sloanje01c,26,56,82
Utah Jazz,UTA,Utah Jazz,2006,1,J. Sloan,sloanje01c,41,41,82
Utah Jazz,UTA,Utah Jazz,2007,1,J. Sloan,sloanje01c,51,31,82
Utah Jazz,UTA,Utah Jazz,2008,1,J. Sloan,sloanje01c,54,28,82
Utah Jazz,UTA,Utah Jazz,2009,1,J. Sloan,sloanje01c,48,34,82
Utah Jazz,UTA,Utah Jazz,2010,1,J. Sloan,sloanje01c,53,29,82
Utah Jazz,UTA,Utah Jazz,2011,1,J. Sloan,sloanje01c,31,23,54
Utah Jazz,UTA,Utah Jazz,2011,2,T. Corbin,corbity01c,8,20,28
Utah Jazz,UTA,Utah Jazz,2012,1,T. Corbin,corbity01c,36,30,66
Utah Jazz,UTA,Utah Jazz,2013,1,T. Corbin,corbity01c,43,39,82
Utah Jazz,UTA,Utah Jazz,2014,1,T. Corbin,corbity01c,25,57,82
Utah Jazz,UTA,Utah Jazz,2015,1,Q. Snyder,snydequ01c,38,44,82
Utah Jazz,UTA,Utah Jazz,2016,1,Q. Snyder,snydequ01c,40,42,82
Utah Jazz,UTA,Utah Jazz,2017,1,Q. Snyder,snydequ01c,51,31,82
Utah Jazz,UTA,Utah Jazz,2018,1,Q. Snyder,snydequ01c,48,34,82
Utah Jazz,UTA,Utah Jazz,2019,1,Q. Snyder,snydequ01c,50,32,82
Utah Jazz,UTA,Utah Jazz,2020,1,Q. Snyder,snydequ01c,41,23,64
Washington Wizards,WAS,Chicago Packers,1962,1,J. Pollard,pollaji01c,18,62,80
Washington Wizards,WAS,Chicago Zephyrs,1963,1,J. McMahon,mcmahja01c,12,26,38
Washington Wizards,WAS,Chicago Zephyrs,1963,2,S. Leonard,leonasl01c,13,29,42
Washington Wizards,WAS,Baltimore Bullets,1964,1,S. Leonard,leonasl01c,31,49,80
Washington Wizards,WAS,Baltimore Bullets,1965,1,B. Jeannette,jeannbu01c,37,43,80
Washington Wizards,WAS,Baltimore Bullets,1966,1,P. Seymour,seymopa01c,38,42,80
Washington Wizards,WAS,Baltimore Bullets,1967,1,M. Farmer,farmemi01c,1,8,9
Washington Wizards,WAS,Baltimore Bullets,1967,2,B. Jeannette,jeannbu01c,3,13,16
Washington Wizards,WAS,Baltimore Bullets,1967,3,G. Shue,shuege01c,16,40,56
Washington Wizards,WAS,Baltimore Bullets,1968,1,G. Shue,shuege01c,36,46,82
Washington Wizards,WAS,Baltimore Bullets,1969,1,G. Shue,shuege01c,57,25,82
Washington Wizards,WAS,Baltimore Bullets,1970,1,G. Shue,shuege01c,50,32,82
Washington Wizards,WAS,Baltimore Bullets,1971,1,G. Shue,shuege01c,42,40,82
Washington Wizards,WAS,Baltimore Bullets,1972,1,G. Shue,shuege01c,38,44,82
Washington Wizards,WAS,Baltimore Bullets,1973,1,G. Shue,shuege01c,52,30,82
Washington Wizards,WAS,Capital Bullets,1974,1,K. Jones,joneskc01c,47,35,82
Washington Wizards,WAS,Washington Bullets,1975,1,K. Jones,joneskc01c,60,22,82
Washington Wizards,WAS,Washington Bullets,1976,1,K. Jones,joneskc01c,48,34,82
Washington Wizards,WAS,Washington Bullets,1977,1,D. Motta,mottadi99c,48,34,82
Washington Wizards,WAS,Washington Bullets,1978,1,D. Motta,mottadi99c,44,38,82
Washington Wizards,WAS,Washington Bullets,1979,1,D. Motta,mottadi99c,54,28,82
Washington Wizards,WAS,Washington Bullets,1980,1,D. Motta,mottadi99c,39,43,82
Washington Wizards,WAS,Washington Bullets,1981,1,G. Shue,shuege01c,39,43,82
Washington Wizards,WAS,Washington Bullets,1982,1,G. Shue,shuege01c,43,39,82
Washington Wizards,WAS,Washington Bullets,1983,1,G. Shue,shuege01c,42,40,82
Washington Wizards,WAS,Washington Bullets,1984,1,G. Shue,shuege01c,35,47,82
Washington Wizards,WAS,Washington Bullets,1985,1,G. Shue,shuege01c,40,42,82
Washington Wizards,WAS,Washington Bullets,1986,1,G. Shue,shuege01c,32,37,69
Washington Wizards,WAS,Washington Bullets,1986,2,K. Loughery,loughke01c,7,6,13
Washington Wizards,WAS,Washington Bullets,1987,1,K. Loughery,loughke01c,42,40,82
Washington Wizards,WAS,Washington Bullets,1988,1,K. Loughery,loughke01c,8,19,27
Washington Wizards,WAS,Washington Bullets,1988,2,W. Unseld,unselwe01c,30,25,55
Washington Wizards,WAS,Washington Bullets,1989,1,W. Unseld,unselwe01c,40,42,82
Washington Wizards,WAS,Washington Bullets,1990,1,W. Unseld,unselwe01c,31,51,82
Washington Wizards,WAS,Washington Bullets,1991,1,W. Unseld,unselwe01c,30,52,82
Washington Wizards,WAS,Washington Bullets,1992,1,W. Unseld,unselwe01c,25,57,82
Washington Wizards,WAS,Washington Bullets,1993,1,W. Unseld,unselwe01c,22,60,82
Washington Wizards,WAS,Washington Bullets,1994,1,W. Unseld,unselwe01c,24,58,82
Washington Wizards,WAS,Washington Bullets,1995,1,J. Lynam,lynamji99c,21,61,82
Washington Wizards,WAS,Washington Bullets,1996,1,J. Lynam,lynamji99c,39,43,82
Washington Wizards,WAS,Washington Bullets,1997,1,J. Lynam,lynamji99c,22,24,46
Washington Wizards,WAS,Washington Bullets,1997,2,B. Staak,staakbo99c,0,1,1
Washington Wizards,WAS,Washington Bullets,1997,3,B. Bickerstaff,bickebe99c,22,13,35
Washington Wizards,WAS,Washington Wizards,1998,1,B. Bickerstaff,bickebe99c,42,40,82
Washington Wizards,WAS,Washington Wizards,1999,1,B. Bickerstaff,bickebe99c,13,19,32
Washington Wizards,WAS,Washington Wizards,1999,2,J. Brovelli,broveji99c,5,13,18
Washington Wizards,WAS,Washington Wizards,2000,1,G. Heard,heardga01c,14,30,44
Washington Wizards,WAS,Washington Wizards,2000,2,D. Walker,walkeda01c,15,23,38
Washington Wizards,WAS,Washington Wizards,2001,1,L. Hamilton,hamille99c,19,63,82
Washington Wizards,WAS,Washington Wizards,2002,1,D. Collins,collido01c,37,45,82
Washington Wizards,WAS,Washington Wizards,2003,1,D. Collins,collido01c,37,45,82
Washington Wizards,WAS,Washington Wizards,2004,1,E. Jordan,jordaed01c,25,57,82
Washington Wizards,WAS,Washington Wizards,2005,1,E. Jordan,jordaed01c,45,37,82
Washington Wizards,WAS,Washington Wizards,2006,1,E. Jordan,jordaed01c,42,40,82
Washington Wizards,WAS,Washington Wizards,2007,1,E. Jordan,jordaed01c,41,41,82
Washington Wizards,WAS,Washington Wizards,2008,1,E. Jordan,jordaed01c,43,39,82
Washington Wizards,WAS,Washington Wizards,2009,1,E. Jordan,jordaed01c,1,10,11
Washington Wizards,WAS,Washington Wizards,2009,2,E. Tapscott,tapsced99c,18,53,71
Washington Wizards,WAS,Washington Wizards,2010,1,F. Saunders,saundfl99c,26,56,82
Washington Wizards,WAS,Washington Wizards,2011,1,F. Saunders,saundfl99c,23,59,82
Washington Wizards,WAS,Washington Wizards,2012,1,F. Saunders,saundfl99c,2,15,17
Washington Wizards,WAS,Washington Wizards,2012,2,R. Wittman,wittmra01c,18,31,49
Washington Wizards,WAS,Washington Wizards,2013,1,R. Wittman,wittmra01c,29,53,82
Washington Wizards,WAS,Washington Wizards,2014,1,R. Wittman,wittmra01c,44,38,82
Washington Wizards,WAS,Washington Wizards,2015,1,R. Wittman,wittmra01c,46,36,82
Washington Wizards,WAS,Washington Wizards,2016,1,R. Wittman,wittmra01c,41,41,82
Washington Wizards,WAS,Washington Wizards,2017,1,S. Brooks,brooksc01c,49,33,82
Washington Wizards,WAS,Washington Wizards,2018,1,S. Brooks,brooksc01c,43,39,82
Washington Wizards,WAS,Washington Wizards,2019,1,S. Brooks,brooksc01c,32,50,82
Washington Wizards,WAS,Washington Wizards,2020,1,S. Brooks,brooksc01c,24,40,64
