team,year,coaches_text,name,wins,losses,total_games,order,correct_order
alabama,2016,Nick Saban (14-1),Nick Saban,14,1,15,1,
alabama,2015,Nick Saban (14-1),Nick Saban,14,1,15,1,
alabama,2014,Nick Saban (12-2),Nick Saban,12,2,14,1,
alabama,2013,Nick Saban (11-2),Nick Saban,11,2,13,1,
alabama,2012,Nick Saban (13-1),Nick Saban,13,1,14,1,
alabama,2011,Nick Saban (12-1),Nick Saban,12,1,13,1,
alabama,2010,Nick Saban (10-3),Nick Saban,10,3,13,1,
alabama,2009,Nick Saban (14-0),Nick Saban,14,0,14,1,
alabama,2008,Nick Saban (12-2),Nick Saban,12,2,14,1,
alabama,2007,Nick Saban (7-6),Nick Saban,7,6,13,1,
alabama,2006,"Mike Shula (6-6), Joe Kines (0-1)",Joe Kines,0,1,1,2,
alabama,2006,"Mike Shula (6-6), Joe Kines (0-1)",Mike Shula,6,6,12,1,
alabama,2005,Mike Shula (10-2),Mike Shula,10,2,12,1,
alabama,2004,Mike Shula (6-6),Mike Shula,6,6,12,1,
alabama,2003,Mike Shula (4-9),Mike Shula,4,9,13,1,
alabama,2002,Dennis Franchione (10-3),Dennis Franchione,10,3,13,1,
alabama,2001,Dennis Franchione (7-5),Dennis Franchione,7,5,12,1,
alabama,2000,Mike DuBose (3-8),Mike DuBose,3,8,11,1,
arizona,2016,Rich Rodriguez (3-9),Rich Rodriguez,3,9,12,1,
arizona,2015,Rich Rodriguez (7-6),Rich Rodriguez,7,6,13,1,
arizona,2014,Rich Rodriguez (10-4),Rich Rodriguez,10,4,14,1,
arizona,2013,Rich Rodriguez (8-5),Rich Rodriguez,8,5,13,1,
arizona,2012,Rich Rodriguez (8-5),Rich Rodriguez,8,5,13,1,
arizona,2011,"Mike Stoops (1-5), Tim Kish (3-3)",Tim Kish,3,3,6,2,
arizona,2011,"Mike Stoops (1-5), Tim Kish (3-3)",Mike Stoops,1,5,6,1,
arizona,2010,Mike Stoops (7-6),Mike Stoops,7,6,13,1,
arizona,2009,Mike Stoops (8-5),Mike Stoops,8,5,13,1,
arizona,2008,Mike Stoops (8-5),Mike Stoops,8,5,13,1,
arizona,2007,Mike Stoops (5-7),Mike Stoops,5,7,12,1,
arizona,2006,Mike Stoops (6-6),Mike Stoops,6,6,12,1,
arizona,2005,Mike Stoops (3-8),Mike Stoops,3,8,11,1,
arizona,2004,Mike Stoops (3-8),Mike Stoops,3,8,11,1,
arizona,2003,"John Mackovic (1-4), Mike Hankwitz (1-6)",Mike Hankwitz,1,6,7,2,
arizona,2003,"John Mackovic (1-4), Mike Hankwitz (1-6)",John Mackovic,1,4,5,1,
arizona,2002,John Mackovic (4-8),John Mackovic,4,8,12,1,
arizona,2001,John Mackovic (5-6),John Mackovic,5,6,11,1,
arizona,2000,Dick Tomey (5-6),Dick Tomey,5,6,11,1,
arizona-state,2016,Todd Graham (5-7),Todd Graham,5,7,12,1,
arizona-state,2015,Todd Graham (6-7),Todd Graham,6,7,13,1,
arizona-state,2014,Todd Graham (10-3),Todd Graham,10,3,13,1,
arizona-state,2013,Todd Graham (10-4),Todd Graham,10,4,14,1,
arizona-state,2012,Todd Graham (8-5),Todd Graham,8,5,13,1,
arizona-state,2011,Dennis Erickson (6-7),Dennis Erickson,6,7,13,1,
arizona-state,2010,Dennis Erickson (6-6),Dennis Erickson,6,6,12,1,
arizona-state,2009,Dennis Erickson (4-8),Dennis Erickson,4,8,12,1,
arizona-state,2008,Dennis Erickson (5-7),Dennis Erickson,5,7,12,1,
arizona-state,2007,Dennis Erickson (10-3),Dennis Erickson,10,3,13,1,
arizona-state,2006,Dirk Koetter (7-6),Dirk Koetter,7,6,13,1,
arizona-state,2005,Dirk Koetter (7-5),Dirk Koetter,7,5,12,1,
arizona-state,2004,Dirk Koetter (9-3),Dirk Koetter,9,3,12,1,
arizona-state,2003,Dirk Koetter (5-7),Dirk Koetter,5,7,12,1,
arizona-state,2002,Dirk Koetter (8-6),Dirk Koetter,8,6,14,1,
arizona-state,2001,Dirk Koetter (4-7),Dirk Koetter,4,7,11,1,
arizona-state,2000,Bruce Snyder (6-6),Bruce Snyder,6,6,12,1,
arkansas,2016,Bret Bielema (7-6),Bret Bielema,7,6,13,1,
arkansas,2015,Bret Bielema (8-5),Bret Bielema,8,5,13,1,
arkansas,2014,Bret Bielema (7-6),Bret Bielema,7,6,13,1,
arkansas,2013,Bret Bielema (3-9),Bret Bielema,3,9,12,1,
arkansas,2012,John Smith (4-8),John Smith,4,8,12,1,
arkansas,2011,Bobby Petrino (11-2),Bobby Petrino,11,2,13,1,
arkansas,2010,Bobby Petrino (10-3),Bobby Petrino,10,3,13,1,
arkansas,2009,Bobby Petrino (8-5),Bobby Petrino,8,5,13,1,
arkansas,2008,Bobby Petrino (5-7),Bobby Petrino,5,7,12,1,
arkansas,2007,"Houston Nutt (8-4), Reggie Herring (0-1)",Reggie Herring,0,1,1,2,
arkansas,2007,"Houston Nutt (8-4), Reggie Herring (0-1)",Houston Nutt,8,4,12,1,
arkansas,2006,Houston Nutt (10-4),Houston Nutt,10,4,14,1,
arkansas,2005,Houston Nutt (4-7),Houston Nutt,4,7,11,1,
arkansas,2004,Houston Nutt (5-6),Houston Nutt,5,6,11,1,
arkansas,2003,Houston Nutt (9-4),Houston Nutt,9,4,13,1,
arkansas,2002,Houston Nutt (9-5),Houston Nutt,9,5,14,1,
arkansas,2001,Houston Nutt (7-5),Houston Nutt,7,5,12,1,
arkansas,2000,Houston Nutt (6-6),Houston Nutt,6,6,12,1,
auburn,2016,Gus Malzahn (8-5),Gus Malzahn,8,5,13,1,
auburn,2015,Gus Malzahn (7-6),Gus Malzahn,7,6,13,1,
auburn,2014,Gus Malzahn (8-5),Gus Malzahn,8,5,13,1,
auburn,2013,Gus Malzahn (12-2),Gus Malzahn,12,2,14,1,
auburn,2012,Gene Chizik (3-9),Gene Chizik,3,9,12,1,
auburn,2011,Gene Chizik (8-5),Gene Chizik,8,5,13,1,
auburn,2010,Gene Chizik (14-0),Gene Chizik,14,0,14,1,
auburn,2009,Gene Chizik (8-5),Gene Chizik,8,5,13,1,
auburn,2008,Tommy Tuberville (5-7),Tommy Tuberville,5,7,12,1,
auburn,2007,Tommy Tuberville (9-4),Tommy Tuberville,9,4,13,1,
auburn,2006,Tommy Tuberville (11-2),Tommy Tuberville,11,2,13,1,
auburn,2005,Tommy Tuberville (9-3),Tommy Tuberville,9,3,12,1,
auburn,2004,Tommy Tuberville (13-0),Tommy Tuberville,13,0,13,1,
auburn,2003,Tommy Tuberville (8-5),Tommy Tuberville,8,5,13,1,
auburn,2002,Tommy Tuberville (9-4),Tommy Tuberville,9,4,13,1,
auburn,2001,Tommy Tuberville (7-5),Tommy Tuberville,7,5,12,1,
auburn,2000,Tommy Tuberville (9-4),Tommy Tuberville,9,4,13,1,
baylor,2016,Jim Grobe (7-6),Jim Grobe,7,6,13,1,
baylor,2015,Art Briles (10-3),Art Briles,10,3,13,1,
baylor,2014,Art Briles (11-2),Art Briles,11,2,13,1,
baylor,2013,Art Briles (11-2),Art Briles,11,2,13,1,
baylor,2012,Art Briles (8-5),Art Briles,8,5,13,1,
baylor,2011,Art Briles (10-3),Art Briles,10,3,13,1,
baylor,2010,Art Briles (7-6),Art Briles,7,6,13,1,
baylor,2009,Art Briles (4-8),Art Briles,4,8,12,1,
baylor,2008,Art Briles (4-8),Art Briles,4,8,12,1,
baylor,2007,Guy Morriss (3-9),Guy Morriss,3,9,12,1,
baylor,2006,Guy Morriss (4-8),Guy Morriss,4,8,12,1,
baylor,2005,Guy Morriss (5-6),Guy Morriss,5,6,11,1,
baylor,2004,Guy Morriss (3-8),Guy Morriss,3,8,11,1,
baylor,2003,Guy Morriss (3-9),Guy Morriss,3,9,12,1,
baylor,2002,Kevin Steele (3-9),Kevin Steele,3,9,12,1,
baylor,2001,Kevin Steele (3-8),Kevin Steele,3,8,11,1,
baylor,2000,Kevin Steele (2-9),Kevin Steele,2,9,11,1,
boston-college,2016,Steve Addazio (7-6),Steve Addazio,7,6,13,1,
boston-college,2015,Steve Addazio (3-9),Steve Addazio,3,9,12,1,
boston-college,2014,Steve Addazio (7-6),Steve Addazio,7,6,13,1,
boston-college,2013,Steve Addazio (7-6),Steve Addazio,7,6,13,1,
boston-college,2012,Frank Spaziani (2-10),Frank Spaziani,2,10,12,1,
boston-college,2011,Frank Spaziani (4-8),Frank Spaziani,4,8,12,1,
boston-college,2010,Frank Spaziani (7-6),Frank Spaziani,7,6,13,1,
boston-college,2009,Frank Spaziani (8-5),Frank Spaziani,8,5,13,1,
boston-college,2008,Jeff Jagodzinski (9-5),Jeff Jagodzinski,9,5,14,1,
boston-college,2007,Jeff Jagodzinski (11-3),Jeff Jagodzinski,11,3,14,1,
boston-college,2006,"Tom O'Brien (9-3), Frank Spaziani (1-0)",Frank Spaziani,1,0,1,2,
boston-college,2006,"Tom O'Brien (9-3), Frank Spaziani (1-0)",Tom O'Brien,9,3,12,1,
boston-college,2005,Tom O'Brien (9-3),Tom O'Brien,9,3,12,1,
boston-college,2004,Tom O'Brien (9-3),Tom O'Brien,9,3,12,1,
boston-college,2003,Tom O'Brien (8-5),Tom O'Brien,8,5,13,1,
boston-college,2002,Tom O'Brien (9-4),Tom O'Brien,9,4,13,1,
boston-college,2001,Tom O'Brien (8-4),Tom O'Brien,8,4,12,1,
boston-college,2000,Tom O'Brien (7-5),Tom O'Brien,7,5,12,1,
california,2016,Sonny Dykes (5-7),Sonny Dykes,5,7,12,1,
california,2015,Sonny Dykes (8-5),Sonny Dykes,8,5,13,1,
california,2014,Sonny Dykes (5-7),Sonny Dykes,5,7,12,1,
california,2013,Sonny Dykes (1-11),Sonny Dykes,1,11,12,1,
california,2012,Jeff Tedford (3-9),Jeff Tedford,3,9,12,1,
california,2011,Jeff Tedford (7-6),Jeff Tedford,7,6,13,1,
california,2010,Jeff Tedford (5-7),Jeff Tedford,5,7,12,1,
california,2009,Jeff Tedford (8-5),Jeff Tedford,8,5,13,1,
california,2008,Jeff Tedford (9-4),Jeff Tedford,9,4,13,1,
california,2007,Jeff Tedford (7-6),Jeff Tedford,7,6,13,1,
california,2006,Jeff Tedford (10-3),Jeff Tedford,10,3,13,1,
california,2005,Jeff Tedford (8-4),Jeff Tedford,8,4,12,1,
california,2004,Jeff Tedford (10-2),Jeff Tedford,10,2,12,1,
california,2003,Jeff Tedford (8-6),Jeff Tedford,8,6,14,1,
california,2002,Jeff Tedford (7-5),Jeff Tedford,7,5,12,1,
california,2001,Tom Holmoe (1-10),Tom Holmoe,1,10,11,1,
california,2000,Tom Holmoe (3-8),Tom Holmoe,3,8,11,1,
clemson,2016,Dabo Swinney (14-1),Dabo Swinney,14,1,15,1,
clemson,2015,Dabo Swinney (14-1),Dabo Swinney,14,1,15,1,
clemson,2014,Dabo Swinney (10-3),Dabo Swinney,10,3,13,1,
clemson,2013,Dabo Swinney (11-2),Dabo Swinney,11,2,13,1,
clemson,2012,Dabo Swinney (11-2),Dabo Swinney,11,2,13,1,
clemson,2011,Dabo Swinney (10-4),Dabo Swinney,10,4,14,1,
clemson,2010,Dabo Swinney (6-7),Dabo Swinney,6,7,13,1,
clemson,2009,Dabo Swinney (9-5),Dabo Swinney,9,5,14,1,
clemson,2008,"Tommy Bowden (3-3), Dabo Swinney (4-3)",Dabo Swinney,4,3,7,2,
clemson,2008,"Tommy Bowden (3-3), Dabo Swinney (4-3)",Tommy Bowden,3,3,6,1,
clemson,2007,Tommy Bowden (9-4),Tommy Bowden,9,4,13,1,
clemson,2006,Tommy Bowden (8-5),Tommy Bowden,8,5,13,1,
clemson,2005,Tommy Bowden (8-4),Tommy Bowden,8,4,12,1,
clemson,2004,Tommy Bowden (6-5),Tommy Bowden,6,5,11,1,
clemson,2003,Tommy Bowden (9-4),Tommy Bowden,9,4,13,1,
clemson,2002,Tommy Bowden (7-6),Tommy Bowden,7,6,13,1,
clemson,2001,Tommy Bowden (7-5),Tommy Bowden,7,5,12,1,
clemson,2000,Tommy Bowden (9-3),Tommy Bowden,9,3,12,1,
colorado,2016,Mike MacIntyre (10-4),Mike MacIntyre,10,4,14,1,
colorado,2015,Mike MacIntyre (4-9),Mike MacIntyre,4,9,13,1,
colorado,2014,Mike MacIntyre (2-10),Mike MacIntyre,2,10,12,1,
colorado,2013,Mike MacIntyre (4-8),Mike MacIntyre,4,8,12,1,
colorado,2012,Jon Embree (1-11),Jon Embree,1,11,12,1,
colorado,2011,Jon Embree (3-10),Jon Embree,3,10,13,1,
colorado,2010,"Dan Hawkins (3-6), Brian Cabral (2-1)",Brian Cabral,2,1,3,2,
colorado,2010,"Dan Hawkins (3-6), Brian Cabral (2-1)",Dan Hawkins,3,6,9,1,
colorado,2009,Dan Hawkins (3-9),Dan Hawkins,3,9,12,1,
colorado,2008,Dan Hawkins (5-7),Dan Hawkins,5,7,12,1,
colorado,2007,Dan Hawkins (6-7),Dan Hawkins,6,7,13,1,
colorado,2006,Dan Hawkins (2-10),Dan Hawkins,2,10,12,1,
colorado,2005,"Gary Barnett (7-5), Mike Hankwitz (0-1)",Mike Hankwitz,0,1,1,2,
colorado,2005,"Gary Barnett (7-5), Mike Hankwitz (0-1)",Gary Barnett,7,5,12,1,
colorado,2004,Gary Barnett (8-5),Gary Barnett,8,5,13,1,
colorado,2003,Gary Barnett (5-7),Gary Barnett,5,7,12,1,
colorado,2002,Gary Barnett (9-5),Gary Barnett,9,5,14,1,
colorado,2001,Gary Barnett (10-3),Gary Barnett,10,3,13,1,
colorado,2000,Gary Barnett (3-8),Gary Barnett,3,8,11,1,
duke,2016,David Cutcliffe (4-8),David Cutcliffe,4,8,12,1,
duke,2015,David Cutcliffe (8-5),David Cutcliffe,8,5,13,1,
duke,2014,David Cutcliffe (9-4),David Cutcliffe,9,4,13,1,
duke,2013,David Cutcliffe (10-4),David Cutcliffe,10,4,14,1,
duke,2012,David Cutcliffe (6-7),David Cutcliffe,6,7,13,1,
duke,2011,David Cutcliffe (3-9),David Cutcliffe,3,9,12,1,
duke,2010,David Cutcliffe (3-9),David Cutcliffe,3,9,12,1,
duke,2009,David Cutcliffe (5-7),David Cutcliffe,5,7,12,1,
duke,2008,David Cutcliffe (4-8),David Cutcliffe,4,8,12,1,
duke,2007,Ted Roof (1-11),Ted Roof,1,11,12,1,
duke,2006,Ted Roof (0-12),Ted Roof,0,12,12,1,
duke,2005,Ted Roof (1-10),Ted Roof,1,10,11,1,
duke,2004,Ted Roof (2-9),Ted Roof,2,9,11,1,
duke,2003,Carl Franks (4-8),Carl Franks,4,8,12,1,
duke,2002,Carl Franks (2-10),Carl Franks,2,10,12,1,
duke,2001,Carl Franks (0-11),Carl Franks,0,11,11,1,
duke,2000,Carl Franks (0-11),Carl Franks,0,11,11,1,
florida,2016,Jim McElwain (9-4),Jim McElwain,9,4,13,1,
florida,2015,Jim McElwain (10-4),Jim McElwain,10,4,14,1,
florida,2014,"D.J. Durkin (1-0), Will Muschamp (6-5)",Will Muschamp,6,5,11,2,1
florida,2014,"D.J. Durkin (1-0), Will Muschamp (6-5)",D.J. Durkin,1,0,1,1,2
florida,2013,Will Muschamp (4-8),Will Muschamp,4,8,12,1,
florida,2012,Will Muschamp (11-2),Will Muschamp,11,2,13,1,
florida,2011,Will Muschamp (7-6),Will Muschamp,7,6,13,1,
florida,2010,Urban Meyer (8-5),Urban Meyer,8,5,13,1,
florida,2009,Urban Meyer (13-1),Urban Meyer,13,1,14,1,
florida,2008,Urban Meyer (13-1),Urban Meyer,13,1,14,1,
florida,2007,Urban Meyer (9-4),Urban Meyer,9,4,13,1,
florida,2006,Urban Meyer (13-1),Urban Meyer,13,1,14,1,
florida,2005,Urban Meyer (9-3),Urban Meyer,9,3,12,1,
florida,2004,"Ron Zook (7-4), Charlie Strong (0-1)",Charlie Strong,0,1,1,2,
florida,2004,"Ron Zook (7-4), Charlie Strong (0-1)",Ron Zook,7,4,11,1,
florida,2003,Ron Zook (8-5),Ron Zook,8,5,13,1,
florida,2002,Ron Zook (8-5),Ron Zook,8,5,13,1,
florida,2001,Steve Spurrier (10-2),Steve Spurrier,10,2,12,1,
florida,2000,Steve Spurrier (10-3),Steve Spurrier,10,3,13,1,
florida-state,2016,Jimbo Fisher (10-3),Jimbo Fisher,10,3,13,1,
florida-state,2015,Jimbo Fisher (10-3),Jimbo Fisher,10,3,13,1,
florida-state,2014,Jimbo Fisher (13-1),Jimbo Fisher,13,1,14,1,
florida-state,2013,Jimbo Fisher (14-0),Jimbo Fisher,14,0,14,1,
florida-state,2012,Jimbo Fisher (12-2),Jimbo Fisher,12,2,14,1,
florida-state,2011,Jimbo Fisher (9-4),Jimbo Fisher,9,4,13,1,
florida-state,2010,Jimbo Fisher (10-4),Jimbo Fisher,10,4,14,1,
florida-state,2009,Bobby Bowden (7-6),Bobby Bowden,7,6,13,1,
florida-state,2008,Bobby Bowden (9-4),Bobby Bowden,9,4,13,1,
florida-state,2007,Bobby Bowden (7-6),Bobby Bowden,7,6,13,1,
florida-state,2006,Bobby Bowden (7-6),Bobby Bowden,7,6,13,1,
florida-state,2005,Bobby Bowden (8-5),Bobby Bowden,8,5,13,1,
florida-state,2004,Bobby Bowden (9-3),Bobby Bowden,9,3,12,1,
florida-state,2003,Bobby Bowden (10-3),Bobby Bowden,10,3,13,1,
florida-state,2002,Bobby Bowden (9-5),Bobby Bowden,9,5,14,1,
florida-state,2001,Bobby Bowden (8-4),Bobby Bowden,8,4,12,1,
florida-state,2000,Bobby Bowden (11-2),Bobby Bowden,11,2,13,1,
georgia,2016,Kirby Smart (8-5),Kirby Smart,8,5,13,1,
georgia,2015,"Bryan McClendon (1-0), Mark Richt (9-3)",Mark Richt,9,3,12,2,1
georgia,2015,"Bryan McClendon (1-0), Mark Richt (9-3)",Bryan McClendon,1,0,1,1,2
georgia,2014,Mark Richt (10-3),Mark Richt,10,3,13,1,
georgia,2013,Mark Richt (8-5),Mark Richt,8,5,13,1,
georgia,2012,Mark Richt (12-2),Mark Richt,12,2,14,1,
georgia,2011,Mark Richt (10-4),Mark Richt,10,4,14,1,
georgia,2010,Mark Richt (6-7),Mark Richt,6,7,13,1,
georgia,2009,Mark Richt (8-5),Mark Richt,8,5,13,1,
georgia,2008,Mark Richt (10-3),Mark Richt,10,3,13,1,
georgia,2007,Mark Richt (11-2),Mark Richt,11,2,13,1,
georgia,2006,Mark Richt (9-4),Mark Richt,9,4,13,1,
georgia,2005,Mark Richt (10-3),Mark Richt,10,3,13,1,
georgia,2004,Mark Richt (10-2),Mark Richt,10,2,12,1,
georgia,2003,Mark Richt (11-3),Mark Richt,11,3,14,1,
georgia,2002,Mark Richt (13-1),Mark Richt,13,1,14,1,
georgia,2001,Mark Richt (8-4),Mark Richt,8,4,12,1,
georgia,2000,Jim Donnan (8-4),Jim Donnan,8,4,12,1,
georgia-tech,2016,Paul Johnson (9-4),Paul Johnson,9,4,13,1,
georgia-tech,2015,Paul Johnson (3-9),Paul Johnson,3,9,12,1,
georgia-tech,2014,Paul Johnson (11-3),Paul Johnson,11,3,14,1,
georgia-tech,2013,Paul Johnson (7-6),Paul Johnson,7,6,13,1,
georgia-tech,2012,Paul Johnson (7-7),Paul Johnson,7,7,14,1,
georgia-tech,2011,Paul Johnson (8-5),Paul Johnson,8,5,13,1,
georgia-tech,2010,Paul Johnson (6-7),Paul Johnson,6,7,13,1,
georgia-tech,2009,Paul Johnson (11-3),Paul Johnson,11,3,14,1,
georgia-tech,2008,Paul Johnson (9-4),Paul Johnson,9,4,13,1,
georgia-tech,2007,"Chan Gailey (7-5), Jon Tenuta (0-1)",Jon Tenuta,0,1,1,2,
georgia-tech,2007,"Chan Gailey (7-5), Jon Tenuta (0-1)",Chan Gailey,7,5,12,1,
georgia-tech,2006,Chan Gailey (9-5),Chan Gailey,9,5,14,1,
georgia-tech,2005,Chan Gailey (7-5),Chan Gailey,7,5,12,1,
georgia-tech,2004,Chan Gailey (7-5),Chan Gailey,7,5,12,1,
georgia-tech,2003,Chan Gailey (7-6),Chan Gailey,7,6,13,1,
georgia-tech,2002,Chan Gailey (7-6),Chan Gailey,7,6,13,1,
georgia-tech,2001,"George O'Leary (7-5), Mac McWhorter (1-0)",Mac McWhorter,1,0,1,2,
georgia-tech,2001,"George O'Leary (7-5), Mac McWhorter (1-0)",George O'Leary,7,5,12,1,
georgia-tech,2000,George O'Leary (9-3),George O'Leary,9,3,12,1,
illinois,2016,Lovie Smith (3-9),Lovie Smith,3,9,12,1,
illinois,2015,Bill Cubit (5-7),Bill Cubit,5,7,12,1,
illinois,2014,Tim Beckman (6-7),Tim Beckman,6,7,13,1,
illinois,2013,Tim Beckman (4-8),Tim Beckman,4,8,12,1,
illinois,2012,Tim Beckman (2-10),Tim Beckman,2,10,12,1,
illinois,2011,"Ron Zook (6-6), Vic Koenning (1-0)",Vic Koenning,1,0,1,2,
illinois,2011,"Ron Zook (6-6), Vic Koenning (1-0)",Ron Zook,6,6,12,1,
illinois,2010,Ron Zook (7-6),Ron Zook,7,6,13,1,
illinois,2009,Ron Zook (3-9),Ron Zook,3,9,12,1,
illinois,2008,Ron Zook (5-7),Ron Zook,5,7,12,1,
illinois,2007,Ron Zook (9-4),Ron Zook,9,4,13,1,
illinois,2006,Ron Zook (2-10),Ron Zook,2,10,12,1,
illinois,2005,Ron Zook (2-9),Ron Zook,2,9,11,1,
illinois,2004,Ron Turner (3-8),Ron Turner,3,8,11,1,
illinois,2003,Ron Turner (1-11),Ron Turner,1,11,12,1,
illinois,2002,Ron Turner (5-7),Ron Turner,5,7,12,1,
illinois,2001,Ron Turner (10-2),Ron Turner,10,2,12,1,
illinois,2000,Ron Turner (5-6),Ron Turner,5,6,11,1,
indiana,2016,"Kevin Wilson (6-6), Tom Allen (0-1)",Tom Allen,0,1,1,2,
indiana,2016,"Kevin Wilson (6-6), Tom Allen (0-1)",Kevin Wilson,6,6,12,1,
indiana,2015,Kevin Wilson (6-7),Kevin Wilson,6,7,13,1,
indiana,2014,Kevin Wilson (4-8),Kevin Wilson,4,8,12,1,
indiana,2013,Kevin Wilson (5-7),Kevin Wilson,5,7,12,1,
indiana,2012,Kevin Wilson (4-8),Kevin Wilson,4,8,12,1,
indiana,2011,Kevin Wilson (1-11),Kevin Wilson,1,11,12,1,
indiana,2010,Bill Lynch (5-7),Bill Lynch,5,7,12,1,
indiana,2009,Bill Lynch (4-8),Bill Lynch,4,8,12,1,
indiana,2008,Bill Lynch (3-9),Bill Lynch,3,9,12,1,
indiana,2007,Bill Lynch (7-6),Bill Lynch,7,6,13,1,
indiana,2006,Terry Hoeppner (5-7),Terry Hoeppner,5,7,12,1,
indiana,2005,Terry Hoeppner (4-7),Terry Hoeppner,4,7,11,1,
indiana,2004,Gerry DiNardo (3-8),Gerry DiNardo,3,8,11,1,
indiana,2003,Gerry DiNardo (2-10),Gerry DiNardo,2,10,12,1,
indiana,2002,Gerry DiNardo (3-9),Gerry DiNardo,3,9,12,1,
indiana,2001,Cam Cameron (5-6),Cam Cameron,5,6,11,1,
indiana,2000,Cam Cameron (3-8),Cam Cameron,3,8,11,1,
iowa,2016,Kirk Ferentz (8-5),Kirk Ferentz,8,5,13,1,
iowa,2015,Kirk Ferentz (12-2),Kirk Ferentz,12,2,14,1,
iowa,2014,Kirk Ferentz (7-6),Kirk Ferentz,7,6,13,1,
iowa,2013,Kirk Ferentz (8-5),Kirk Ferentz,8,5,13,1,
iowa,2012,Kirk Ferentz (4-8),Kirk Ferentz,4,8,12,1,
iowa,2011,Kirk Ferentz (7-6),Kirk Ferentz,7,6,13,1,
iowa,2010,Kirk Ferentz (8-5),Kirk Ferentz,8,5,13,1,
iowa,2009,Kirk Ferentz (11-2),Kirk Ferentz,11,2,13,1,
iowa,2008,Kirk Ferentz (9-4),Kirk Ferentz,9,4,13,1,
iowa,2007,Kirk Ferentz (6-6),Kirk Ferentz,6,6,12,1,
iowa,2006,Kirk Ferentz (6-7),Kirk Ferentz,6,7,13,1,
iowa,2005,Kirk Ferentz (7-5),Kirk Ferentz,7,5,12,1,
iowa,2004,Kirk Ferentz (10-2),Kirk Ferentz,10,2,12,1,
iowa,2003,Kirk Ferentz (10-3),Kirk Ferentz,10,3,13,1,
iowa,2002,Kirk Ferentz (11-2),Kirk Ferentz,11,2,13,1,
iowa,2001,Kirk Ferentz (7-5),Kirk Ferentz,7,5,12,1,
iowa,2000,Kirk Ferentz (3-9),Kirk Ferentz,3,9,12,1,
iowa-state,2016,Matt Campbell (3-9),Matt Campbell,3,9,12,1,
iowa-state,2015,Paul Rhoads (3-9),Paul Rhoads,3,9,12,1,
iowa-state,2014,Paul Rhoads (2-10),Paul Rhoads,2,10,12,1,
iowa-state,2013,Paul Rhoads (3-9),Paul Rhoads,3,9,12,1,
iowa-state,2012,Paul Rhoads (6-7),Paul Rhoads,6,7,13,1,
iowa-state,2011,Paul Rhoads (6-7),Paul Rhoads,6,7,13,1,
iowa-state,2010,Paul Rhoads (5-7),Paul Rhoads,5,7,12,1,
iowa-state,2009,Paul Rhoads (7-6),Paul Rhoads,7,6,13,1,
iowa-state,2008,Gene Chizik (2-10),Gene Chizik,2,10,12,1,
iowa-state,2007,Gene Chizik (3-9),Gene Chizik,3,9,12,1,
iowa-state,2006,Dan McCarney (4-8),Dan McCarney,4,8,12,1,
iowa-state,2005,Dan McCarney (7-5),Dan McCarney,7,5,12,1,
iowa-state,2004,Dan McCarney (7-5),Dan McCarney,7,5,12,1,
iowa-state,2003,Dan McCarney (2-10),Dan McCarney,2,10,12,1,
iowa-state,2002,Dan McCarney (7-7),Dan McCarney,7,7,14,1,
iowa-state,2001,Dan McCarney (7-5),Dan McCarney,7,5,12,1,
iowa-state,2000,Dan McCarney (9-3),Dan McCarney,9,3,12,1,
kansas,2016,David Beaty (2-10),David Beaty,2,10,12,1,
kansas,2015,David Beaty (0-12),David Beaty,0,12,12,1,
kansas,2014,"Charlie Weis (2-2), Clint Bowen (1-7)",Clint Bowen,1,7,8,2,
kansas,2014,"Charlie Weis (2-2), Clint Bowen (1-7)",Charlie Weis,2,2,4,1,
kansas,2013,Charlie Weis (3-9),Charlie Weis,3,9,12,1,
kansas,2012,Charlie Weis (1-11),Charlie Weis,1,11,12,1,
kansas,2011,Turner Gill (2-10),Turner Gill,2,10,12,1,
kansas,2010,Turner Gill (3-9),Turner Gill,3,9,12,1,
kansas,2009,Mark Mangino (5-7),Mark Mangino,5,7,12,1,
kansas,2008,Mark Mangino (8-5),Mark Mangino,8,5,13,1,
kansas,2007,Mark Mangino (12-1),Mark Mangino,12,1,13,1,
kansas,2006,Mark Mangino (6-6),Mark Mangino,6,6,12,1,
kansas,2005,Mark Mangino (7-5),Mark Mangino,7,5,12,1,
kansas,2004,Mark Mangino (4-7),Mark Mangino,4,7,11,1,
kansas,2003,Mark Mangino (6-7),Mark Mangino,6,7,13,1,
kansas,2002,Mark Mangino (2-10),Mark Mangino,2,10,12,1,
kansas,2001,"Terry Allen (2-6), Tom Hayes (1-2)",Tom Hayes,1,2,3,2,
kansas,2001,"Terry Allen (2-6), Tom Hayes (1-2)",Terry Allen,2,6,8,1,
kansas,2000,Terry Allen (4-7),Terry Allen,4,7,11,1,
kansas-state,2016,Bill Snyder (9-4),Bill Snyder,9,4,13,1,
kansas-state,2015,Bill Snyder (6-7),Bill Snyder,6,7,13,1,
kansas-state,2014,Bill Snyder (9-4),Bill Snyder,9,4,13,1,
kansas-state,2013,Bill Snyder (8-5),Bill Snyder,8,5,13,1,
kansas-state,2012,Bill Snyder (11-2),Bill Snyder,11,2,13,1,
kansas-state,2011,Bill Snyder (10-3),Bill Snyder,10,3,13,1,
kansas-state,2010,Bill Snyder (7-6),Bill Snyder,7,6,13,1,
kansas-state,2009,Bill Snyder (6-6),Bill Snyder,6,6,12,1,
kansas-state,2008,Ron Prince (5-7),Ron Prince,5,7,12,1,
kansas-state,2007,Ron Prince (5-7),Ron Prince,5,7,12,1,
kansas-state,2006,Ron Prince (7-6),Ron Prince,7,6,13,1,
kansas-state,2005,Bill Snyder (5-6),Bill Snyder,5,6,11,1,
kansas-state,2004,Bill Snyder (4-7),Bill Snyder,4,7,11,1,
kansas-state,2003,Bill Snyder (11-4),Bill Snyder,11,4,15,1,
kansas-state,2002,Bill Snyder (11-2),Bill Snyder,11,2,13,1,
kansas-state,2001,Bill Snyder (6-6),Bill Snyder,6,6,12,1,
kansas-state,2000,Bill Snyder (11-3),Bill Snyder,11,3,14,1,
kentucky,2016,Mark Stoops (7-6),Mark Stoops,7,6,13,1,
kentucky,2015,Mark Stoops (5-7),Mark Stoops,5,7,12,1,
kentucky,2014,Mark Stoops (5-7),Mark Stoops,5,7,12,1,
kentucky,2013,Mark Stoops (2-10),Mark Stoops,2,10,12,1,
kentucky,2012,Joker Phillips (2-10),Joker Phillips,2,10,12,1,
kentucky,2011,Joker Phillips (5-7),Joker Phillips,5,7,12,1,
kentucky,2010,Joker Phillips (6-7),Joker Phillips,6,7,13,1,
kentucky,2009,Rich Brooks (7-6),Rich Brooks,7,6,13,1,
kentucky,2008,Rich Brooks (7-6),Rich Brooks,7,6,13,1,
kentucky,2007,Rich Brooks (8-5),Rich Brooks,8,5,13,1,
kentucky,2006,Rich Brooks (8-5),Rich Brooks,8,5,13,1,
kentucky,2005,Rich Brooks (3-8),Rich Brooks,3,8,11,1,
kentucky,2004,Rich Brooks (2-9),Rich Brooks,2,9,11,1,
kentucky,2003,Rich Brooks (4-8),Rich Brooks,4,8,12,1,
kentucky,2002,Guy Morriss (7-5),Guy Morriss,7,5,12,1,
kentucky,2001,Guy Morriss (2-9),Guy Morriss,2,9,11,1,
kentucky,2000,Hal Mumme (2-9),Hal Mumme,2,9,11,1,
louisville,2016,Bobby Petrino (9-4),Bobby Petrino,9,4,13,1,
louisville,2015,Bobby Petrino (8-5),Bobby Petrino,8,5,13,1,
louisville,2014,Bobby Petrino (9-4),Bobby Petrino,9,4,13,1,
louisville,2013,Charlie Strong (12-1),Charlie Strong,12,1,13,1,
louisville,2012,Charlie Strong (11-2),Charlie Strong,11,2,13,1,
louisville,2011,Charlie Strong (7-6),Charlie Strong,7,6,13,1,
louisville,2010,Charlie Strong (7-6),Charlie Strong,7,6,13,1,
louisville,2009,Steve Kragthorpe (4-8),Steve Kragthorpe,4,8,12,1,
louisville,2008,Steve Kragthorpe (5-7),Steve Kragthorpe,5,7,12,1,
louisville,2007,Steve Kragthorpe (6-6),Steve Kragthorpe,6,6,12,1,
louisville,2006,Bobby Petrino (12-1),Bobby Petrino,12,1,13,1,
louisville,2005,Bobby Petrino (9-3),Bobby Petrino,9,3,12,1,
louisville,2004,Bobby Petrino (11-1),Bobby Petrino,11,1,12,1,
louisville,2003,Bobby Petrino (9-4),Bobby Petrino,9,4,13,1,
louisville,2002,John Smith (7-6),John Smith,7,6,13,1,
louisville,2001,John Smith (11-2),John Smith,11,2,13,1,
louisville,2000,John Smith (9-3),John Smith,9,3,12,1,
louisiana-state,2016,"Ed Orgeron (6-2), Les Miles (2-2)",Les Miles,2,2,4,2,1
louisiana-state,2016,"Ed Orgeron (6-2), Les Miles (2-2)",Ed Orgeron,6,2,8,1,2
louisiana-state,2015,Les Miles (9-3),Les Miles,9,3,12,1,
louisiana-state,2014,Les Miles (8-5),Les Miles,8,5,13,1,
louisiana-state,2013,Les Miles (10-3),Les Miles,10,3,13,1,
louisiana-state,2012,Les Miles (10-3),Les Miles,10,3,13,1,
louisiana-state,2011,Les Miles (13-1),Les Miles,13,1,14,1,
louisiana-state,2010,Les Miles (11-2),Les Miles,11,2,13,1,
louisiana-state,2009,Les Miles (9-4),Les Miles,9,4,13,1,
louisiana-state,2008,Les Miles (8-5),Les Miles,8,5,13,1,
louisiana-state,2007,Les Miles (12-2),Les Miles,12,2,14,1,
louisiana-state,2006,Les Miles (11-2),Les Miles,11,2,13,1,
louisiana-state,2005,Les Miles (11-2),Les Miles,11,2,13,1,
louisiana-state,2004,Nick Saban (9-3),Nick Saban,9,3,12,1,
louisiana-state,2003,Nick Saban (13-1),Nick Saban,13,1,14,1,
louisiana-state,2002,Nick Saban (8-5),Nick Saban,8,5,13,1,
louisiana-state,2001,Nick Saban (10-3),Nick Saban,10,3,13,1,
louisiana-state,2000,Nick Saban (8-4),Nick Saban,8,4,12,1,
maryland,2016,D.J. Durkin (6-7),D.J. Durkin,6,7,13,1,
maryland,2015,"Randy Edsall (2-4), Mike Locksley (1-5)",Mike Locksley,1,5,6,2,
maryland,2015,"Randy Edsall (2-4), Mike Locksley (1-5)",Randy Edsall,2,4,6,1,
maryland,2014,Randy Edsall (7-6),Randy Edsall,7,6,13,1,
maryland,2013,Randy Edsall (7-6),Randy Edsall,7,6,13,1,
maryland,2012,Randy Edsall (4-8),Randy Edsall,4,8,12,1,
maryland,2011,Randy Edsall (2-10),Randy Edsall,2,10,12,1,
maryland,2010,Ralph Friedgen (9-4),Ralph Friedgen,9,4,13,1,
maryland,2009,Ralph Friedgen (2-10),Ralph Friedgen,2,10,12,1,
maryland,2008,Ralph Friedgen (8-5),Ralph Friedgen,8,5,13,1,
maryland,2007,Ralph Friedgen (6-7),Ralph Friedgen,6,7,13,1,
maryland,2006,Ralph Friedgen (9-4),Ralph Friedgen,9,4,13,1,
maryland,2005,Ralph Friedgen (5-6),Ralph Friedgen,5,6,11,1,
maryland,2004,Ralph Friedgen (5-6),Ralph Friedgen,5,6,11,1,
maryland,2003,Ralph Friedgen (10-3),Ralph Friedgen,10,3,13,1,
maryland,2002,Ralph Friedgen (11-3),Ralph Friedgen,11,3,14,1,
maryland,2001,Ralph Friedgen (10-2),Ralph Friedgen,10,2,12,1,
maryland,2000,Ron Vanderlinden (5-6),Ron Vanderlinden,5,6,11,1,
miami-fl,2016,Mark Richt (9-4),Mark Richt,9,4,13,1,
miami-fl,2015,"Al Golden (4-3), Larry Scott (4-2)",Larry Scott,4,2,6,2,
miami-fl,2015,"Al Golden (4-3), Larry Scott (4-2)",Al Golden,4,3,7,1,
miami-fl,2014,Al Golden (6-7),Al Golden,6,7,13,1,
miami-fl,2013,Al Golden (9-4),Al Golden,9,4,13,1,
miami-fl,2012,Al Golden (7-5),Al Golden,7,5,12,1,
miami-fl,2011,Al Golden (6-6),Al Golden,6,6,12,1,
miami-fl,2010,"Randy Shannon (7-5), Jeff Stoutland (0-1)",Jeff Stoutland,0,1,1,2,
miami-fl,2010,"Randy Shannon (7-5), Jeff Stoutland (0-1)",Randy Shannon,7,5,12,1,
miami-fl,2009,Randy Shannon (9-4),Randy Shannon,9,4,13,1,
miami-fl,2008,Randy Shannon (7-6),Randy Shannon,7,6,13,1,
miami-fl,2007,Randy Shannon (5-7),Randy Shannon,5,7,12,1,
miami-fl,2006,Larry Coker (7-6),Larry Coker,7,6,13,1,
miami-fl,2005,Larry Coker (9-3),Larry Coker,9,3,12,1,
miami-fl,2004,Larry Coker (9-3),Larry Coker,9,3,12,1,
miami-fl,2003,Larry Coker (11-2),Larry Coker,11,2,13,1,
miami-fl,2002,Larry Coker (12-1),Larry Coker,12,1,13,1,
miami-fl,2001,Larry Coker (12-0),Larry Coker,12,0,12,1,
miami-fl,2000,Butch Davis (11-1),Butch Davis,11,1,12,1,
michigan,2016,Jim Harbaugh (10-3),Jim Harbaugh,10,3,13,1,
michigan,2015,Jim Harbaugh (10-3),Jim Harbaugh,10,3,13,1,
michigan,2014,Brady Hoke (5-7),Brady Hoke,5,7,12,1,
michigan,2013,Brady Hoke (7-6),Brady Hoke,7,6,13,1,
michigan,2012,Brady Hoke (8-5),Brady Hoke,8,5,13,1,
michigan,2011,Brady Hoke (11-2),Brady Hoke,11,2,13,1,
michigan,2010,Rich Rodriguez (7-6),Rich Rodriguez,7,6,13,1,
michigan,2009,Rich Rodriguez (5-7),Rich Rodriguez,5,7,12,1,
michigan,2008,Rich Rodriguez (3-9),Rich Rodriguez,3,9,12,1,
michigan,2007,Lloyd Carr (9-4),Lloyd Carr,9,4,13,1,
michigan,2006,Lloyd Carr (11-2),Lloyd Carr,11,2,13,1,
michigan,2005,Lloyd Carr (7-5),Lloyd Carr,7,5,12,1,
michigan,2004,Lloyd Carr (9-3),Lloyd Carr,9,3,12,1,
michigan,2003,Lloyd Carr (10-3),Lloyd Carr,10,3,13,1,
michigan,2002,Lloyd Carr (10-3),Lloyd Carr,10,3,13,1,
michigan,2001,Lloyd Carr (8-4),Lloyd Carr,8,4,12,1,
michigan,2000,Lloyd Carr (9-3),Lloyd Carr,9,3,12,1,
michigan-state,2016,Mark Dantonio (3-9),Mark Dantonio,3,9,12,1,
michigan-state,2015,Mark Dantonio (12-2),Mark Dantonio,12,2,14,1,
michigan-state,2014,Mark Dantonio (11-2),Mark Dantonio,11,2,13,1,
michigan-state,2013,Mark Dantonio (13-1),Mark Dantonio,13,1,14,1,
michigan-state,2012,Mark Dantonio (7-6),Mark Dantonio,7,6,13,1,
michigan-state,2011,Mark Dantonio (11-3),Mark Dantonio,11,3,14,1,
michigan-state,2010,Mark Dantonio (11-2),Mark Dantonio,11,2,13,1,
michigan-state,2009,Mark Dantonio (6-7),Mark Dantonio,6,7,13,1,
michigan-state,2008,Mark Dantonio (9-4),Mark Dantonio,9,4,13,1,
michigan-state,2007,Mark Dantonio (7-6),Mark Dantonio,7,6,13,1,
michigan-state,2006,John Smith (4-8),John Smith,4,8,12,1,
michigan-state,2005,John Smith (5-6),John Smith,5,6,11,1,
michigan-state,2004,John Smith (5-7),John Smith,5,7,12,1,
michigan-state,2003,John Smith (8-5),John Smith,8,5,13,1,
michigan-state,2002,"Bobby Williams (3-6), Morris Watts (1-2)",Morris Watts,1,2,3,2,
michigan-state,2002,"Bobby Williams (3-6), Morris Watts (1-2)",Bobby Williams,3,6,9,1,
michigan-state,2001,Bobby Williams (7-5),Bobby Williams,7,5,12,1,
michigan-state,2000,Bobby Williams (5-6),Bobby Williams,5,6,11,1,
minnesota,2016,Tracy Claeys (9-4),Tracy Claeys,9,4,13,1,
minnesota,2015,"Jerry Kill (4-3), Tracy Claeys (2-4)",Tracy Claeys,2,4,6,2,
minnesota,2015,"Jerry Kill (4-3), Tracy Claeys (2-4)",Jerry Kill,4,3,7,1,
minnesota,2014,Jerry Kill (8-5),Jerry Kill,8,5,13,1,
minnesota,2013,Jerry Kill (8-5),Jerry Kill,8,5,13,1,
minnesota,2012,Jerry Kill (6-7),Jerry Kill,6,7,13,1,
minnesota,2011,Jerry Kill (3-9),Jerry Kill,3,9,12,1,
minnesota,2010,"Tim Brewster (1-6), Jeff Horton (2-3)",Jeff Horton,2,3,5,2,
minnesota,2010,"Tim Brewster (1-6), Jeff Horton (2-3)",Tim Brewster,1,6,7,1,
minnesota,2009,Tim Brewster (6-7),Tim Brewster,6,7,13,1,
minnesota,2008,Tim Brewster (7-6),Tim Brewster,7,6,13,1,
minnesota,2007,Tim Brewster (1-11),Tim Brewster,1,11,12,1,
minnesota,2006,Glen Mason (6-7),Glen Mason,6,7,13,1,
minnesota,2005,Glen Mason (7-5),Glen Mason,7,5,12,1,
minnesota,2004,Glen Mason (7-5),Glen Mason,7,5,12,1,
minnesota,2003,Glen Mason (10-3),Glen Mason,10,3,13,1,
minnesota,2002,Glen Mason (8-5),Glen Mason,8,5,13,1,
minnesota,2001,Glen Mason (4-7),Glen Mason,4,7,11,1,
minnesota,2000,Glen Mason (6-6),Glen Mason,6,6,12,1,
mississippi-state,2016,Dan Mullen (6-7),Dan Mullen,6,7,13,1,
mississippi-state,2015,Dan Mullen (9-4),Dan Mullen,9,4,13,1,
mississippi-state,2014,Dan Mullen (10-3),Dan Mullen,10,3,13,1,
mississippi-state,2013,Dan Mullen (7-6),Dan Mullen,7,6,13,1,
mississippi-state,2012,Dan Mullen (8-5),Dan Mullen,8,5,13,1,
mississippi-state,2011,Dan Mullen (7-6),Dan Mullen,7,6,13,1,
mississippi-state,2010,Dan Mullen (9-4),Dan Mullen,9,4,13,1,
mississippi-state,2009,Dan Mullen (5-7),Dan Mullen,5,7,12,1,
mississippi-state,2008,Sylvester Croom (4-8),Sylvester Croom,4,8,12,1,
mississippi-state,2007,Sylvester Croom (8-5),Sylvester Croom,8,5,13,1,
mississippi-state,2006,Sylvester Croom (3-9),Sylvester Croom,3,9,12,1,
mississippi-state,2005,Sylvester Croom (3-8),Sylvester Croom,3,8,11,1,
mississippi-state,2004,Sylvester Croom (3-8),Sylvester Croom,3,8,11,1,
mississippi-state,2003,Jackie Sherrill (2-10),Jackie Sherrill,2,10,12,1,
mississippi-state,2002,Jackie Sherrill (3-9),Jackie Sherrill,3,9,12,1,
mississippi-state,2001,Jackie Sherrill (3-8),Jackie Sherrill,3,8,11,1,
mississippi-state,2000,Jackie Sherrill (8-4),Jackie Sherrill,8,4,12,1,
missouri,2016,Barry Odom (4-8),Barry Odom,4,8,12,1,
missouri,2015,Gary Pinkel (5-7),Gary Pinkel,5,7,12,1,
missouri,2014,Gary Pinkel (11-3),Gary Pinkel,11,3,14,1,
missouri,2013,Gary Pinkel (12-2),Gary Pinkel,12,2,14,1,
missouri,2012,Gary Pinkel (5-7),Gary Pinkel,5,7,12,1,
missouri,2011,Gary Pinkel (8-5),Gary Pinkel,8,5,13,1,
missouri,2010,Gary Pinkel (10-3),Gary Pinkel,10,3,13,1,
missouri,2009,Gary Pinkel (8-5),Gary Pinkel,8,5,13,1,
missouri,2008,Gary Pinkel (10-4),Gary Pinkel,10,4,14,1,
missouri,2007,Gary Pinkel (12-2),Gary Pinkel,12,2,14,1,
missouri,2006,Gary Pinkel (8-5),Gary Pinkel,8,5,13,1,
missouri,2005,Gary Pinkel (7-5),Gary Pinkel,7,5,12,1,
missouri,2004,Gary Pinkel (5-6),Gary Pinkel,5,6,11,1,
missouri,2003,Gary Pinkel (8-5),Gary Pinkel,8,5,13,1,
missouri,2002,Gary Pinkel (5-7),Gary Pinkel,5,7,12,1,
missouri,2001,Gary Pinkel (4-7),Gary Pinkel,4,7,11,1,
missouri,2000,Larry Smith (3-8),Larry Smith,3,8,11,1,
nebraska,2016,Mike Riley (9-4),Mike Riley,9,4,13,1,
nebraska,2015,Mike Riley (6-7),Mike Riley,6,7,13,1,
nebraska,2014,"Barney Cotton (0-1), Bo Pelini (9-3)",Bo Pelini,9,3,12,2,1
nebraska,2014,"Barney Cotton (0-1), Bo Pelini (9-3)",Barney Cotton,0,1,1,1,2
nebraska,2013,Bo Pelini (9-4),Bo Pelini,9,4,13,1,
nebraska,2012,Bo Pelini (10-4),Bo Pelini,10,4,14,1,
nebraska,2011,Bo Pelini (9-4),Bo Pelini,9,4,13,1,
nebraska,2010,Bo Pelini (10-4),Bo Pelini,10,4,14,1,
nebraska,2009,Bo Pelini (10-4),Bo Pelini,10,4,14,1,
nebraska,2008,Bo Pelini (9-4),Bo Pelini,9,4,13,1,
nebraska,2007,Bill Callahan (5-7),Bill Callahan,5,7,12,1,
nebraska,2006,Bill Callahan (9-5),Bill Callahan,9,5,14,1,
nebraska,2005,Bill Callahan (8-4),Bill Callahan,8,4,12,1,
nebraska,2004,Bill Callahan (5-6),Bill Callahan,5,6,11,1,
nebraska,2003,"Frank Solich (9-3), Bo Pelini (1-0)",Bo Pelini,1,0,1,2,
nebraska,2003,"Frank Solich (9-3), Bo Pelini (1-0)",Frank Solich,9,3,12,1,
nebraska,2002,Frank Solich (7-7),Frank Solich,7,7,14,1,
nebraska,2001,Frank Solich (11-2),Frank Solich,11,2,13,1,
nebraska,2000,Frank Solich (10-2),Frank Solich,10,2,12,1,
north-carolina,2016,Larry Fedora (8-5),Larry Fedora,8,5,13,1,
north-carolina,2015,Larry Fedora (11-3),Larry Fedora,11,3,14,1,
north-carolina,2014,Larry Fedora (6-7),Larry Fedora,6,7,13,1,
north-carolina,2013,Larry Fedora (7-6),Larry Fedora,7,6,13,1,
north-carolina,2012,Larry Fedora (8-4),Larry Fedora,8,4,12,1,
north-carolina,2011,Everett Withers (7-6),Everett Withers,7,6,13,1,
north-carolina,2010,Butch Davis (8-5),Butch Davis,8,5,13,1,
north-carolina,2009,Butch Davis (8-5),Butch Davis,8,5,13,1,
north-carolina,2008,Butch Davis (8-5),Butch Davis,8,5,13,1,
north-carolina,2007,Butch Davis (4-8),Butch Davis,4,8,12,1,
north-carolina,2006,John Bunting (3-9),John Bunting,3,9,12,1,
north-carolina,2005,John Bunting (5-6),John Bunting,5,6,11,1,
north-carolina,2004,John Bunting (6-6),John Bunting,6,6,12,1,
north-carolina,2003,John Bunting (2-10),John Bunting,2,10,12,1,
north-carolina,2002,John Bunting (3-9),John Bunting,3,9,12,1,
north-carolina,2001,John Bunting (8-5),John Bunting,8,5,13,1,
north-carolina,2000,Carl Torbush (6-5),Carl Torbush,6,5,11,1,
north-carolina-state,2016,Dave Doeren (7-6),Dave Doeren,7,6,13,1,
north-carolina-state,2015,Dave Doeren (7-6),Dave Doeren,7,6,13,1,
north-carolina-state,2014,Dave Doeren (8-5),Dave Doeren,8,5,13,1,
north-carolina-state,2013,Dave Doeren (3-9),Dave Doeren,3,9,12,1,
north-carolina-state,2012,"Tom O'Brien (7-5), Dana Bible (0-1)",Dana Bible,0,1,1,2,
north-carolina-state,2012,"Tom O'Brien (7-5), Dana Bible (0-1)",Tom O'Brien,7,5,12,1,
north-carolina-state,2011,Tom O'Brien (8-5),Tom O'Brien,8,5,13,1,
north-carolina-state,2010,Tom O'Brien (9-4),Tom O'Brien,9,4,13,1,
north-carolina-state,2009,Tom O'Brien (5-7),Tom O'Brien,5,7,12,1,
north-carolina-state,2008,Tom O'Brien (6-7),Tom O'Brien,6,7,13,1,
north-carolina-state,2007,Tom O'Brien (5-7),Tom O'Brien,5,7,12,1,
north-carolina-state,2006,Chuck Amato (3-9),Chuck Amato,3,9,12,1,
north-carolina-state,2005,Chuck Amato (7-5),Chuck Amato,7,5,12,1,
north-carolina-state,2004,Chuck Amato (5-6),Chuck Amato,5,6,11,1,
north-carolina-state,2003,Chuck Amato (8-5),Chuck Amato,8,5,13,1,
north-carolina-state,2002,Chuck Amato (11-3),Chuck Amato,11,3,14,1,
north-carolina-state,2001,Chuck Amato (7-5),Chuck Amato,7,5,12,1,
north-carolina-state,2000,Chuck Amato (8-4),Chuck Amato,8,4,12,1,
northwestern,2016,Pat Fitzgerald (7-6),Pat Fitzgerald,7,6,13,1,
northwestern,2015,Pat Fitzgerald (10-3),Pat Fitzgerald,10,3,13,1,
northwestern,2014,Pat Fitzgerald (5-7),Pat Fitzgerald,5,7,12,1,
northwestern,2013,Pat Fitzgerald (5-7),Pat Fitzgerald,5,7,12,1,
northwestern,2012,Pat Fitzgerald (10-3),Pat Fitzgerald,10,3,13,1,
northwestern,2011,Pat Fitzgerald (6-7),Pat Fitzgerald,6,7,13,1,
northwestern,2010,Pat Fitzgerald (7-6),Pat Fitzgerald,7,6,13,1,
northwestern,2009,Pat Fitzgerald (8-5),Pat Fitzgerald,8,5,13,1,
northwestern,2008,Pat Fitzgerald (9-4),Pat Fitzgerald,9,4,13,1,
northwestern,2007,Pat Fitzgerald (6-6),Pat Fitzgerald,6,6,12,1,
northwestern,2006,Pat Fitzgerald (4-8),Pat Fitzgerald,4,8,12,1,
northwestern,2005,Randy Walker (7-5),Randy Walker,7,5,12,1,
northwestern,2004,Randy Walker (6-6),Randy Walker,6,6,12,1,
northwestern,2003,Randy Walker (6-7),Randy Walker,6,7,13,1,
northwestern,2002,Randy Walker (3-9),Randy Walker,3,9,12,1,
northwestern,2001,Randy Walker (4-7),Randy Walker,4,7,11,1,
northwestern,2000,Randy Walker (8-4),Randy Walker,8,4,12,1,
notre-dame,2016,Brian Kelly (4-8),Brian Kelly,4,8,12,1,
notre-dame,2015,Brian Kelly (10-3),Brian Kelly,10,3,13,1,
notre-dame,2014,Brian Kelly (8-5),Brian Kelly,8,5,13,1,
notre-dame,2013,Brian Kelly (9-4),Brian Kelly,9,4,13,1,
notre-dame,2012,Brian Kelly (12-1),Brian Kelly,12,1,13,1,
notre-dame,2011,Brian Kelly (8-5),Brian Kelly,8,5,13,1,
notre-dame,2010,Brian Kelly (8-5),Brian Kelly,8,5,13,1,
notre-dame,2009,Charlie Weis (6-6),Charlie Weis,6,6,12,1,
notre-dame,2008,Charlie Weis (7-6),Charlie Weis,7,6,13,1,
notre-dame,2007,Charlie Weis (3-9),Charlie Weis,3,9,12,1,
notre-dame,2006,Charlie Weis (10-3),Charlie Weis,10,3,13,1,
notre-dame,2005,Charlie Weis (9-3),Charlie Weis,9,3,12,1,
notre-dame,2004,"Tyrone Willingham (6-5), Kent Baer (0-1)",Kent Baer,0,1,1,2,
notre-dame,2004,"Tyrone Willingham (6-5), Kent Baer (0-1)",Tyrone Willingham,6,5,11,1,
notre-dame,2003,Tyrone Willingham (5-7),Tyrone Willingham,5,7,12,1,
notre-dame,2002,Tyrone Willingham (10-3),Tyrone Willingham,10,3,13,1,
notre-dame,2001,Bob Davie (5-6),Bob Davie,5,6,11,1,
notre-dame,2000,Bob Davie (9-3),Bob Davie,9,3,12,1,
ohio-state,2016,Urban Meyer (11-2),Urban Meyer,11,2,13,1,
ohio-state,2015,Urban Meyer (12-1),Urban Meyer,12,1,13,1,
ohio-state,2014,Urban Meyer (14-1),Urban Meyer,14,1,15,1,
ohio-state,2013,Urban Meyer (12-2),Urban Meyer,12,2,14,1,
ohio-state,2012,Urban Meyer (12-0),Urban Meyer,12,0,12,1,
ohio-state,2011,Luke Fickell (6-7),Luke Fickell,6,7,13,1,
ohio-state,2010,Jim Tressel (12-1),Jim Tressel,12,1,13,1,
ohio-state,2009,Jim Tressel (11-2),Jim Tressel,11,2,13,1,
ohio-state,2008,Jim Tressel (10-3),Jim Tressel,10,3,13,1,
ohio-state,2007,Jim Tressel (11-2),Jim Tressel,11,2,13,1,
ohio-state,2006,Jim Tressel (12-1),Jim Tressel,12,1,13,1,
ohio-state,2005,Jim Tressel (10-2),Jim Tressel,10,2,12,1,
ohio-state,2004,Jim Tressel (8-4),Jim Tressel,8,4,12,1,
ohio-state,2003,Jim Tressel (11-2),Jim Tressel,11,2,13,1,
ohio-state,2002,Jim Tressel (14-0),Jim Tressel,14,0,14,1,
ohio-state,2001,Jim Tressel (7-5),Jim Tressel,7,5,12,1,
ohio-state,2000,John Cooper (8-4),John Cooper,8,4,12,1,
oklahoma,2016,Bob Stoops (11-2),Bob Stoops,11,2,13,1,
oklahoma,2015,Bob Stoops (11-2),Bob Stoops,11,2,13,1,
oklahoma,2014,Bob Stoops (8-5),Bob Stoops,8,5,13,1,
oklahoma,2013,Bob Stoops (11-2),Bob Stoops,11,2,13,1,
oklahoma,2012,Bob Stoops (10-3),Bob Stoops,10,3,13,1,
oklahoma,2011,Bob Stoops (10-3),Bob Stoops,10,3,13,1,
oklahoma,2010,Bob Stoops (12-2),Bob Stoops,12,2,14,1,
oklahoma,2009,Bob Stoops (8-5),Bob Stoops,8,5,13,1,
oklahoma,2008,Bob Stoops (12-2),Bob Stoops,12,2,14,1,
oklahoma,2007,Bob Stoops (11-3),Bob Stoops,11,3,14,1,
oklahoma,2006,Bob Stoops (11-3),Bob Stoops,11,3,14,1,
oklahoma,2005,Bob Stoops (8-4),Bob Stoops,8,4,12,1,
oklahoma,2004,Bob Stoops (12-1),Bob Stoops,12,1,13,1,
oklahoma,2003,Bob Stoops (12-2),Bob Stoops,12,2,14,1,
oklahoma,2002,Bob Stoops (12-2),Bob Stoops,12,2,14,1,
oklahoma,2001,Bob Stoops (11-2),Bob Stoops,11,2,13,1,
oklahoma,2000,Bob Stoops (13-0),Bob Stoops,13,0,13,1,
oklahoma-state,2016,Mike Gundy (10-3),Mike Gundy,10,3,13,1,
oklahoma-state,2015,Mike Gundy (10-3),Mike Gundy,10,3,13,1,
oklahoma-state,2014,Mike Gundy (7-6),Mike Gundy,7,6,13,1,
oklahoma-state,2013,Mike Gundy (10-3),Mike Gundy,10,3,13,1,
oklahoma-state,2012,Mike Gundy (8-5),Mike Gundy,8,5,13,1,
oklahoma-state,2011,Mike Gundy (12-1),Mike Gundy,12,1,13,1,
oklahoma-state,2010,Mike Gundy (11-2),Mike Gundy,11,2,13,1,
oklahoma-state,2009,Mike Gundy (9-4),Mike Gundy,9,4,13,1,
oklahoma-state,2008,Mike Gundy (9-4),Mike Gundy,9,4,13,1,
oklahoma-state,2007,Mike Gundy (7-6),Mike Gundy,7,6,13,1,
oklahoma-state,2006,Mike Gundy (7-6),Mike Gundy,7,6,13,1,
oklahoma-state,2005,Mike Gundy (4-7),Mike Gundy,4,7,11,1,
oklahoma-state,2004,Les Miles (7-5),Les Miles,7,5,12,1,
oklahoma-state,2003,Les Miles (9-4),Les Miles,9,4,13,1,
oklahoma-state,2002,Les Miles (8-5),Les Miles,8,5,13,1,
oklahoma-state,2001,Les Miles (4-7),Les Miles,4,7,11,1,
oklahoma-state,2000,Bob Simmons (3-8),Bob Simmons,3,8,11,1,
mississippi,2016,Hugh Freeze (5-7),Hugh Freeze,5,7,12,1,
mississippi,2015,Hugh Freeze (10-3),Hugh Freeze,10,3,13,1,
mississippi,2014,Hugh Freeze (9-4),Hugh Freeze,9,4,13,1,
mississippi,2013,Hugh Freeze (8-5),Hugh Freeze,8,5,13,1,
mississippi,2012,Hugh Freeze (7-6),Hugh Freeze,7,6,13,1,
mississippi,2011,Houston Nutt (2-10),Houston Nutt,2,10,12,1,
mississippi,2010,Houston Nutt (4-8),Houston Nutt,4,8,12,1,
mississippi,2009,Houston Nutt (9-4),Houston Nutt,9,4,13,1,
mississippi,2008,Houston Nutt (9-4),Houston Nutt,9,4,13,1,
mississippi,2007,Ed Orgeron (3-9),Ed Orgeron,3,9,12,1,
mississippi,2006,Ed Orgeron (4-8),Ed Orgeron,4,8,12,1,
mississippi,2005,Ed Orgeron (3-8),Ed Orgeron,3,8,11,1,
mississippi,2004,David Cutcliffe (4-7),David Cutcliffe,4,7,11,1,
mississippi,2003,David Cutcliffe (10-3),David Cutcliffe,10,3,13,1,
mississippi,2002,David Cutcliffe (7-6),David Cutcliffe,7,6,13,1,
mississippi,2001,David Cutcliffe (7-4),David Cutcliffe,7,4,11,1,
mississippi,2000,David Cutcliffe (7-5),David Cutcliffe,7,5,12,1,
oregon,2016,Mark Helfrich (4-8),Mark Helfrich,4,8,12,1,
oregon,2015,Mark Helfrich (9-4),Mark Helfrich,9,4,13,1,
oregon,2014,Mark Helfrich (13-2),Mark Helfrich,13,2,15,1,
oregon,2013,Mark Helfrich (11-2),Mark Helfrich,11,2,13,1,
oregon,2012,Chip Kelly (12-1),Chip Kelly,12,1,13,1,
oregon,2011,Chip Kelly (12-2),Chip Kelly,12,2,14,1,
oregon,2010,Chip Kelly (12-1),Chip Kelly,12,1,13,1,
oregon,2009,Chip Kelly (10-3),Chip Kelly,10,3,13,1,
oregon,2008,Mike Bellotti (10-3),Mike Bellotti,10,3,13,1,
oregon,2007,Mike Bellotti (9-4),Mike Bellotti,9,4,13,1,
oregon,2006,Mike Bellotti (7-6),Mike Bellotti,7,6,13,1,
oregon,2005,Mike Bellotti (10-2),Mike Bellotti,10,2,12,1,
oregon,2004,Mike Bellotti (5-6),Mike Bellotti,5,6,11,1,
oregon,2003,Mike Bellotti (8-5),Mike Bellotti,8,5,13,1,
oregon,2002,Mike Bellotti (7-6),Mike Bellotti,7,6,13,1,
oregon,2001,Mike Bellotti (11-1),Mike Bellotti,11,1,12,1,
oregon,2000,Mike Bellotti (10-2),Mike Bellotti,10,2,12,1,
oregon-state,2016,Gary Andersen (4-8),Gary Andersen,4,8,12,1,
oregon-state,2015,Gary Andersen (2-10),Gary Andersen,2,10,12,1,
oregon-state,2014,Mike Riley (5-7),Mike Riley,5,7,12,1,
oregon-state,2013,Mike Riley (7-6),Mike Riley,7,6,13,1,
oregon-state,2012,Mike Riley (9-4),Mike Riley,9,4,13,1,
oregon-state,2011,Mike Riley (3-9),Mike Riley,3,9,12,1,
oregon-state,2010,Mike Riley (5-7),Mike Riley,5,7,12,1,
oregon-state,2009,Mike Riley (8-5),Mike Riley,8,5,13,1,
oregon-state,2008,Mike Riley (9-4),Mike Riley,9,4,13,1,
oregon-state,2007,Mike Riley (9-4),Mike Riley,9,4,13,1,
oregon-state,2006,Mike Riley (10-4),Mike Riley,10,4,14,1,
oregon-state,2005,Mike Riley (5-6),Mike Riley,5,6,11,1,
oregon-state,2004,Mike Riley (7-5),Mike Riley,7,5,12,1,
oregon-state,2003,Mike Riley (8-5),Mike Riley,8,5,13,1,
oregon-state,2002,Dennis Erickson (8-5),Dennis Erickson,8,5,13,1,
oregon-state,2001,Dennis Erickson (5-6),Dennis Erickson,5,6,11,1,
oregon-state,2000,Dennis Erickson (11-1),Dennis Erickson,11,1,12,1,
penn-state,2016,James Franklin (11-3),James Franklin,11,3,14,1,
penn-state,2015,James Franklin (7-6),James Franklin,7,6,13,1,
penn-state,2014,James Franklin (7-6),James Franklin,7,6,13,1,
penn-state,2013,Bill O'Brien (7-5),Bill O'Brien,7,5,12,1,
penn-state,2012,Bill O'Brien (8-4),Bill O'Brien,8,4,12,1,
penn-state,2011,"Joe Paterno (8-1), Tom Bradley (1-3)",Tom Bradley,1,3,4,2,
penn-state,2011,"Joe Paterno (8-1), Tom Bradley (1-3)",Joe Paterno,8,1,9,1,
penn-state,2010,Joe Paterno (7-6),Joe Paterno,7,6,13,1,
penn-state,2009,Joe Paterno (11-2),Joe Paterno,11,2,13,1,
penn-state,2008,Joe Paterno (11-2),Joe Paterno,11,2,13,1,
penn-state,2007,Joe Paterno (9-4),Joe Paterno,9,4,13,1,
penn-state,2006,Joe Paterno (9-4),Joe Paterno,9,4,13,1,
penn-state,2005,Joe Paterno (11-1),Joe Paterno,11,1,12,1,
penn-state,2004,Joe Paterno (4-7),Joe Paterno,4,7,11,1,
penn-state,2003,Joe Paterno (3-9),Joe Paterno,3,9,12,1,
penn-state,2002,Joe Paterno (9-4),Joe Paterno,9,4,13,1,
penn-state,2001,Joe Paterno (5-6),Joe Paterno,5,6,11,1,
penn-state,2000,Joe Paterno (5-7),Joe Paterno,5,7,12,1,
pittsburgh,2016,Pat Narduzzi (8-5),Pat Narduzzi,8,5,13,1,
pittsburgh,2015,Pat Narduzzi (8-5),Pat Narduzzi,8,5,13,1,
pittsburgh,2014,"Joe Rudolph (0-1), Paul Chryst (6-6)",Paul Chryst,6,6,12,2,1
pittsburgh,2014,"Joe Rudolph (0-1), Paul Chryst (6-6)",Joe Rudolph,0,1,1,1,2
pittsburgh,2013,Paul Chryst (7-6),Paul Chryst,7,6,13,1,
pittsburgh,2012,Paul Chryst (6-7),Paul Chryst,6,7,13,1,
pittsburgh,2011,"Todd Graham (6-6), Keith Patterson (0-1)",Keith Patterson,0,1,1,2,
pittsburgh,2011,"Todd Graham (6-6), Keith Patterson (0-1)",Todd Graham,6,6,12,1,
pittsburgh,2010,"Dave Wannstedt (7-5), Phil Bennett (1-0)",Phil Bennett,1,0,1,2,
pittsburgh,2010,"Dave Wannstedt (7-5), Phil Bennett (1-0)",Dave Wannstedt,7,5,12,1,
pittsburgh,2009,Dave Wannstedt (10-3),Dave Wannstedt,10,3,13,1,
pittsburgh,2008,Dave Wannstedt (9-4),Dave Wannstedt,9,4,13,1,
pittsburgh,2007,Dave Wannstedt (5-7),Dave Wannstedt,5,7,12,1,
pittsburgh,2006,Dave Wannstedt (6-6),Dave Wannstedt,6,6,12,1,
pittsburgh,2005,Dave Wannstedt (5-6),Dave Wannstedt,5,6,11,1,
pittsburgh,2004,Walt Harris (8-4),Walt Harris,8,4,12,1,
pittsburgh,2003,Walt Harris (8-5),Walt Harris,8,5,13,1,
pittsburgh,2002,Walt Harris (9-4),Walt Harris,9,4,13,1,
pittsburgh,2001,Walt Harris (7-5),Walt Harris,7,5,12,1,
pittsburgh,2000,Walt Harris (7-5),Walt Harris,7,5,12,1,
purdue,2016,"Darrell Hazell (3-3), Gerad Parker (0-6)",Gerad Parker,0,6,6,2,
purdue,2016,"Darrell Hazell (3-3), Gerad Parker (0-6)",Darrell Hazell,3,3,6,1,
purdue,2015,Darrell Hazell (2-10),Darrell Hazell,2,10,12,1,
purdue,2014,Darrell Hazell (3-9),Darrell Hazell,3,9,12,1,
purdue,2013,Darrell Hazell (1-11),Darrell Hazell,1,11,12,1,
purdue,2012,"Danny Hope (6-6), Patrick Higgins (0-1)",Patrick Higgins,0,1,1,2,
purdue,2012,"Danny Hope (6-6), Patrick Higgins (0-1)",Danny Hope,6,6,12,1,
purdue,2011,Danny Hope (7-6),Danny Hope,7,6,13,1,
purdue,2010,Danny Hope (4-8),Danny Hope,4,8,12,1,
purdue,2009,Danny Hope (5-7),Danny Hope,5,7,12,1,
purdue,2008,Joe Tiller (4-8),Joe Tiller,4,8,12,1,
purdue,2007,Joe Tiller (8-5),Joe Tiller,8,5,13,1,
purdue,2006,Joe Tiller (8-6),Joe Tiller,8,6,14,1,
purdue,2005,Joe Tiller (5-6),Joe Tiller,5,6,11,1,
purdue,2004,Joe Tiller (7-5),Joe Tiller,7,5,12,1,
purdue,2003,Joe Tiller (9-4),Joe Tiller,9,4,13,1,
purdue,2002,Joe Tiller (7-6),Joe Tiller,7,6,13,1,
purdue,2001,Joe Tiller (6-6),Joe Tiller,6,6,12,1,
purdue,2000,Joe Tiller (8-4),Joe Tiller,8,4,12,1,
rutgers,2016,Chris Ash (2-10),Chris Ash,2,10,12,1,
rutgers,2015,Kyle Flood (4-8),Kyle Flood,4,8,12,1,
rutgers,2014,Kyle Flood (8-5),Kyle Flood,8,5,13,1,
rutgers,2013,Kyle Flood (6-7),Kyle Flood,6,7,13,1,
rutgers,2012,Kyle Flood (9-4),Kyle Flood,9,4,13,1,
rutgers,2011,Greg Schiano (9-4),Greg Schiano,9,4,13,1,
rutgers,2010,Greg Schiano (4-8),Greg Schiano,4,8,12,1,
rutgers,2009,Greg Schiano (9-4),Greg Schiano,9,4,13,1,
rutgers,2008,Greg Schiano (8-5),Greg Schiano,8,5,13,1,
rutgers,2007,Greg Schiano (8-5),Greg Schiano,8,5,13,1,
rutgers,2006,Greg Schiano (11-2),Greg Schiano,11,2,13,1,
rutgers,2005,Greg Schiano (7-5),Greg Schiano,7,5,12,1,
rutgers,2004,Greg Schiano (4-7),Greg Schiano,4,7,11,1,
rutgers,2003,Greg Schiano (5-7),Greg Schiano,5,7,12,1,
rutgers,2002,Greg Schiano (1-11),Greg Schiano,1,11,12,1,
rutgers,2001,Greg Schiano (2-9),Greg Schiano,2,9,11,1,
rutgers,2000,Terry Shea (3-8),Terry Shea,3,8,11,1,
south-carolina,2016,Will Muschamp (6-7),Will Muschamp,6,7,13,1,
south-carolina,2015,"Steve Spurrier (2-4), Shawn Elliott (1-5)",Shawn Elliott,1,5,6,2,
south-carolina,2015,"Steve Spurrier (2-4), Shawn Elliott (1-5)",Steve Spurrier,2,4,6,1,
south-carolina,2014,Steve Spurrier (7-6),Steve Spurrier,7,6,13,1,
south-carolina,2013,Steve Spurrier (11-2),Steve Spurrier,11,2,13,1,
south-carolina,2012,Steve Spurrier (11-2),Steve Spurrier,11,2,13,1,
south-carolina,2011,Steve Spurrier (11-2),Steve Spurrier,11,2,13,1,
south-carolina,2010,Steve Spurrier (9-5),Steve Spurrier,9,5,14,1,
south-carolina,2009,Steve Spurrier (7-6),Steve Spurrier,7,6,13,1,
south-carolina,2008,Steve Spurrier (7-6),Steve Spurrier,7,6,13,1,
south-carolina,2007,Steve Spurrier (6-6),Steve Spurrier,6,6,12,1,
south-carolina,2006,Steve Spurrier (8-5),Steve Spurrier,8,5,13,1,
south-carolina,2005,Steve Spurrier (7-5),Steve Spurrier,7,5,12,1,
south-carolina,2004,Lou Holtz (6-5),Lou Holtz,6,5,11,1,
south-carolina,2003,Lou Holtz (5-7),Lou Holtz,5,7,12,1,
south-carolina,2002,Lou Holtz (5-7),Lou Holtz,5,7,12,1,
south-carolina,2001,Lou Holtz (9-3),Lou Holtz,9,3,12,1,
south-carolina,2000,Lou Holtz (8-4),Lou Holtz,8,4,12,1,
stanford,2016,David Shaw (10-3),David Shaw,10,3,13,1,
stanford,2015,David Shaw (12-2),David Shaw,12,2,14,1,
stanford,2014,David Shaw (8-5),David Shaw,8,5,13,1,
stanford,2013,David Shaw (11-3),David Shaw,11,3,14,1,
stanford,2012,David Shaw (12-2),David Shaw,12,2,14,1,
stanford,2011,David Shaw (11-2),David Shaw,11,2,13,1,
stanford,2010,Jim Harbaugh (12-1),Jim Harbaugh,12,1,13,1,
stanford,2009,Jim Harbaugh (8-5),Jim Harbaugh,8,5,13,1,
stanford,2008,Jim Harbaugh (5-7),Jim Harbaugh,5,7,12,1,
stanford,2007,Jim Harbaugh (4-8),Jim Harbaugh,4,8,12,1,
stanford,2006,Walt Harris (1-11),Walt Harris,1,11,12,1,
stanford,2005,Walt Harris (5-6),Walt Harris,5,6,11,1,
stanford,2004,Buddy Teevens (4-7),Buddy Teevens,4,7,11,1,
stanford,2003,Buddy Teevens (4-7),Buddy Teevens,4,7,11,1,
stanford,2002,Buddy Teevens (2-9),Buddy Teevens,2,9,11,1,
stanford,2001,Tyrone Willingham (9-3),Tyrone Willingham,9,3,12,1,
stanford,2000,Tyrone Willingham (5-6),Tyrone Willingham,5,6,11,1,
syracuse,2016,Dino Babers (4-8),Dino Babers,4,8,12,1,
syracuse,2015,Scott Shafer (4-8),Scott Shafer,4,8,12,1,
syracuse,2014,Scott Shafer (3-9),Scott Shafer,3,9,12,1,
syracuse,2013,Scott Shafer (7-6),Scott Shafer,7,6,13,1,
syracuse,2012,Doug Marrone (8-5),Doug Marrone,8,5,13,1,
syracuse,2011,Doug Marrone (5-7),Doug Marrone,5,7,12,1,
syracuse,2010,Doug Marrone (8-5),Doug Marrone,8,5,13,1,
syracuse,2009,Doug Marrone (4-8),Doug Marrone,4,8,12,1,
syracuse,2008,Greg Robinson (3-9),Greg Robinson,3,9,12,1,
syracuse,2007,Greg Robinson (2-10),Greg Robinson,2,10,12,1,
syracuse,2006,Greg Robinson (4-8),Greg Robinson,4,8,12,1,
syracuse,2005,Greg Robinson (1-10),Greg Robinson,1,10,11,1,
syracuse,2004,Paul Pasqualoni (6-6),Paul Pasqualoni,6,6,12,1,
syracuse,2003,Paul Pasqualoni (6-6),Paul Pasqualoni,6,6,12,1,
syracuse,2002,Paul Pasqualoni (4-8),Paul Pasqualoni,4,8,12,1,
syracuse,2001,Paul Pasqualoni (10-3),Paul Pasqualoni,10,3,13,1,
syracuse,2000,Paul Pasqualoni (6-5),Paul Pasqualoni,6,5,11,1,
tennessee,2016,Butch Jones (9-4),Butch Jones,9,4,13,1,
tennessee,2015,Butch Jones (9-4),Butch Jones,9,4,13,1,
tennessee,2014,Butch Jones (7-6),Butch Jones,7,6,13,1,
tennessee,2013,Butch Jones (5-7),Butch Jones,5,7,12,1,
tennessee,2012,"Derek Dooley (4-7), Jim Chaney (1-0)",Jim Chaney,1,0,1,2,
tennessee,2012,"Derek Dooley (4-7), Jim Chaney (1-0)",Derek Dooley,4,7,11,1,
tennessee,2011,Derek Dooley (5-7),Derek Dooley,5,7,12,1,
tennessee,2010,Derek Dooley (6-7),Derek Dooley,6,7,13,1,
tennessee,2009,Lane Kiffin (7-6),Lane Kiffin,7,6,13,1,
tennessee,2008,Phillip Fulmer (5-7),Phillip Fulmer,5,7,12,1,
tennessee,2007,Phillip Fulmer (10-4),Phillip Fulmer,10,4,14,1,
tennessee,2006,Phillip Fulmer (9-4),Phillip Fulmer,9,4,13,1,
tennessee,2005,Phillip Fulmer (5-6),Phillip Fulmer,5,6,11,1,
tennessee,2004,Phillip Fulmer (10-3),Phillip Fulmer,10,3,13,1,
tennessee,2003,Phillip Fulmer (10-3),Phillip Fulmer,10,3,13,1,
tennessee,2002,Phillip Fulmer (8-5),Phillip Fulmer,8,5,13,1,
tennessee,2001,Phillip Fulmer (11-2),Phillip Fulmer,11,2,13,1,
tennessee,2000,Phillip Fulmer (8-4),Phillip Fulmer,8,4,12,1,
texas,2016,Charlie Strong (5-7),Charlie Strong,5,7,12,1,
texas,2015,Charlie Strong (5-7),Charlie Strong,5,7,12,1,
texas,2014,Charlie Strong (6-7),Charlie Strong,6,7,13,1,
texas,2013,Mack Brown (8-5),Mack Brown,8,5,13,1,
texas,2012,Mack Brown (9-4),Mack Brown,9,4,13,1,
texas,2011,Mack Brown (8-5),Mack Brown,8,5,13,1,
texas,2010,Mack Brown (5-7),Mack Brown,5,7,12,1,
texas,2009,Mack Brown (13-1),Mack Brown,13,1,14,1,
texas,2008,Mack Brown (12-1),Mack Brown,12,1,13,1,
texas,2007,Mack Brown (10-3),Mack Brown,10,3,13,1,
texas,2006,Mack Brown (10-3),Mack Brown,10,3,13,1,
texas,2005,Mack Brown (13-0),Mack Brown,13,0,13,1,
texas,2004,Mack Brown (11-1),Mack Brown,11,1,12,1,
texas,2003,Mack Brown (10-3),Mack Brown,10,3,13,1,
texas,2002,Mack Brown (11-2),Mack Brown,11,2,13,1,
texas,2001,Mack Brown (11-2),Mack Brown,11,2,13,1,
texas,2000,Mack Brown (9-3),Mack Brown,9,3,12,1,
texas-am,2016,Kevin Sumlin (8-5),Kevin Sumlin,8,5,13,1,
texas-am,2015,Kevin Sumlin (8-5),Kevin Sumlin,8,5,13,1,
texas-am,2014,Kevin Sumlin (8-5),Kevin Sumlin,8,5,13,1,
texas-am,2013,Kevin Sumlin (9-4),Kevin Sumlin,9,4,13,1,
texas-am,2012,Kevin Sumlin (11-2),Kevin Sumlin,11,2,13,1,
texas-am,2011,"Mike Sherman (6-6), Tim DeRuyter (1-0)",Tim DeRuyter,1,0,1,2,
texas-am,2011,"Mike Sherman (6-6), Tim DeRuyter (1-0)",Mike Sherman,6,6,12,1,
texas-am,2010,Mike Sherman (9-4),Mike Sherman,9,4,13,1,
texas-am,2009,Mike Sherman (6-7),Mike Sherman,6,7,13,1,
texas-am,2008,Mike Sherman (4-8),Mike Sherman,4,8,12,1,
texas-am,2007,Dennis Franchione (7-6),Dennis Franchione,7,6,13,1,
texas-am,2006,Dennis Franchione (9-4),Dennis Franchione,9,4,13,1,
texas-am,2005,Dennis Franchione (5-6),Dennis Franchione,5,6,11,1,
texas-am,2004,Dennis Franchione (7-5),Dennis Franchione,7,5,12,1,
texas-am,2003,Dennis Franchione (4-8),Dennis Franchione,4,8,12,1,
texas-am,2002,R.C. Slocum (6-6),R.C. Slocum,6,6,12,1,
texas-am,2001,R.C. Slocum (8-4),R.C. Slocum,8,4,12,1,
texas-am,2000,R.C. Slocum (7-5),R.C. Slocum,7,5,12,1,
texas-christian,2016,Gary Patterson (6-7),Gary Patterson,6,7,13,1,
texas-christian,2015,Gary Patterson (11-2),Gary Patterson,11,2,13,1,
texas-christian,2014,Gary Patterson (12-1),Gary Patterson,12,1,13,1,
texas-christian,2013,Gary Patterson (4-8),Gary Patterson,4,8,12,1,
texas-christian,2012,Gary Patterson (7-6),Gary Patterson,7,6,13,1,
texas-christian,2011,Gary Patterson (11-2),Gary Patterson,11,2,13,1,
texas-christian,2010,Gary Patterson (13-0),Gary Patterson,13,0,13,1,
texas-christian,2009,Gary Patterson (12-1),Gary Patterson,12,1,13,1,
texas-christian,2008,Gary Patterson (11-2),Gary Patterson,11,2,13,1,
texas-christian,2007,Gary Patterson (8-5),Gary Patterson,8,5,13,1,
texas-christian,2006,Gary Patterson (11-2),Gary Patterson,11,2,13,1,
texas-christian,2005,Gary Patterson (11-1),Gary Patterson,11,1,12,1,
texas-christian,2004,Gary Patterson (5-6),Gary Patterson,5,6,11,1,
texas-christian,2003,Gary Patterson (11-2),Gary Patterson,11,2,13,1,
texas-christian,2002,Gary Patterson (10-2),Gary Patterson,10,2,12,1,
texas-christian,2001,Gary Patterson (6-6),Gary Patterson,6,6,12,1,
texas-christian,2000,"Dennis Franchione (10-1), Gary Patterson (0-1)",Gary Patterson,0,1,1,2,
texas-christian,2000,"Dennis Franchione (10-1), Gary Patterson (0-1)",Dennis Franchione,10,1,11,1,
texas-tech,2016,Kliff Kingsbury (5-7),Kliff Kingsbury,5,7,12,1,
texas-tech,2015,Kliff Kingsbury (7-6),Kliff Kingsbury,7,6,13,1,
texas-tech,2014,Kliff Kingsbury (4-8),Kliff Kingsbury,4,8,12,1,
texas-tech,2013,Kliff Kingsbury (8-5),Kliff Kingsbury,8,5,13,1,
texas-tech,2012,"Tommy Tuberville (7-5), Chris Thomsen (1-0)",Chris Thomsen,1,0,1,2,
texas-tech,2012,"Tommy Tuberville (7-5), Chris Thomsen (1-0)",Tommy Tuberville,7,5,12,1,
texas-tech,2011,Tommy Tuberville (5-7),Tommy Tuberville,5,7,12,1,
texas-tech,2010,Tommy Tuberville (8-5),Tommy Tuberville,8,5,13,1,
texas-tech,2009,"Mike Leach (8-4), Ruffin McNeill (1-0)",Ruffin McNeill,1,0,1,2,
texas-tech,2009,"Mike Leach (8-4), Ruffin McNeill (1-0)",Mike Leach,8,4,12,1,
texas-tech,2008,Mike Leach (11-2),Mike Leach,11,2,13,1,
texas-tech,2007,Mike Leach (9-4),Mike Leach,9,4,13,1,
texas-tech,2006,Mike Leach (8-5),Mike Leach,8,5,13,1,
texas-tech,2005,Mike Leach (9-3),Mike Leach,9,3,12,1,
texas-tech,2004,Mike Leach (8-4),Mike Leach,8,4,12,1,
texas-tech,2003,Mike Leach (8-5),Mike Leach,8,5,13,1,
texas-tech,2002,Mike Leach (9-5),Mike Leach,9,5,14,1,
texas-tech,2001,Mike Leach (7-5),Mike Leach,7,5,12,1,
texas-tech,2000,Mike Leach (7-6),Mike Leach,7,6,13,1,
ucla,2016,Jim Mora (4-8),Jim Mora,4,8,12,1,
ucla,2015,Jim Mora (8-5),Jim Mora,8,5,13,1,
ucla,2014,Jim Mora (10-3),Jim Mora,10,3,13,1,
ucla,2013,Jim Mora (10-3),Jim Mora,10,3,13,1,
ucla,2012,Jim Mora (9-5),Jim Mora,9,5,14,1,
ucla,2011,"Rick Neuheisel (6-6), Mike Johnson (0-2)",Mike Johnson,0,2,2,2,
ucla,2011,"Rick Neuheisel (6-6), Mike Johnson (0-2)",Rick Neuheisel,6,6,12,1,
ucla,2010,Rick Neuheisel (4-8),Rick Neuheisel,4,8,12,1,
ucla,2009,Rick Neuheisel (7-6),Rick Neuheisel,7,6,13,1,
ucla,2008,Rick Neuheisel (4-8),Rick Neuheisel,4,8,12,1,
ucla,2007,"Karl Dorrell (6-6), DeWayne Walker (0-1)",DeWayne Walker,0,1,1,2,
ucla,2007,"Karl Dorrell (6-6), DeWayne Walker (0-1)",Karl Dorrell,6,6,12,1,
ucla,2006,Karl Dorrell (7-6),Karl Dorrell,7,6,13,1,
ucla,2005,Karl Dorrell (10-2),Karl Dorrell,10,2,12,1,
ucla,2004,Karl Dorrell (6-6),Karl Dorrell,6,6,12,1,
ucla,2003,Karl Dorrell (6-7),Karl Dorrell,6,7,13,1,
ucla,2002,"Bob Toledo (7-5), Ed Kezirian (1-0)",Ed Kezirian,1,0,1,2,
ucla,2002,"Bob Toledo (7-5), Ed Kezirian (1-0)",Bob Toledo,7,5,12,1,
ucla,2001,Bob Toledo (7-4),Bob Toledo,7,4,11,1,
ucla,2000,Bob Toledo (6-6),Bob Toledo,6,6,12,1,
southern-california,2016,Clay Helton (10-3),Clay Helton,10,3,13,1,
southern-california,2015,"Clay Helton (5-4), Steve Sarkisian (3-2)",Steve Sarkisian,3,2,5,2,1
southern-california,2015,"Clay Helton (5-4), Steve Sarkisian (3-2)",Clay Helton,5,4,9,1,2
southern-california,2014,Steve Sarkisian (9-4),Steve Sarkisian,9,4,13,1,
southern-california,2013,"Clay Helton (1-0), Lane Kiffin (3-2), Ed Orgeron (6-2)",Ed Orgeron,6,2,8,3,2
southern-california,2013,"Clay Helton (1-0), Lane Kiffin (3-2), Ed Orgeron (6-2)",Lane Kiffin,3,2,5,2,1
southern-california,2013,"Clay Helton (1-0), Lane Kiffin (3-2), Ed Orgeron (6-2)",Clay Helton,1,0,1,1,3
southern-california,2012,Lane Kiffin (7-6),Lane Kiffin,7,6,13,1,
southern-california,2011,Lane Kiffin (10-2),Lane Kiffin,10,2,12,1,
southern-california,2010,Lane Kiffin (8-5),Lane Kiffin,8,5,13,1,
southern-california,2009,Pete Carroll (9-4),Pete Carroll,9,4,13,1,
southern-california,2008,Pete Carroll (12-1),Pete Carroll,12,1,13,1,
southern-california,2007,Pete Carroll (11-2),Pete Carroll,11,2,13,1,
southern-california,2006,Pete Carroll (11-2),Pete Carroll,11,2,13,1,
southern-california,2005,Pete Carroll (12-1),Pete Carroll,12,1,13,1,
southern-california,2004,Pete Carroll (13-0),Pete Carroll,13,0,13,1,
southern-california,2003,Pete Carroll (12-1),Pete Carroll,12,1,13,1,
southern-california,2002,Pete Carroll (11-2),Pete Carroll,11,2,13,1,
southern-california,2001,Pete Carroll (6-6),Pete Carroll,6,6,12,1,
southern-california,2000,Paul Hackett (5-7),Paul Hackett,5,7,12,1,
utah,2016,Kyle Whittingham (9-4),Kyle Whittingham,9,4,13,1,
utah,2015,Kyle Whittingham (10-3),Kyle Whittingham,10,3,13,1,
utah,2014,Kyle Whittingham (9-4),Kyle Whittingham,9,4,13,1,
utah,2013,Kyle Whittingham (5-7),Kyle Whittingham,5,7,12,1,
utah,2012,Kyle Whittingham (5-7),Kyle Whittingham,5,7,12,1,
utah,2011,Kyle Whittingham (8-5),Kyle Whittingham,8,5,13,1,
utah,2010,Kyle Whittingham (10-3),Kyle Whittingham,10,3,13,1,
utah,2009,Kyle Whittingham (10-3),Kyle Whittingham,10,3,13,1,
utah,2008,Kyle Whittingham (13-0),Kyle Whittingham,13,0,13,1,
utah,2007,Kyle Whittingham (9-4),Kyle Whittingham,9,4,13,1,
utah,2006,Kyle Whittingham (8-5),Kyle Whittingham,8,5,13,1,
utah,2005,Kyle Whittingham (7-5),Kyle Whittingham,7,5,12,1,
utah,2004,"Kyle Whittingham (1-0), Urban Meyer (12-0)",Urban Meyer,12,0,12,2,1
utah,2004,"Kyle Whittingham (1-0), Urban Meyer (12-0)",Kyle Whittingham,1,0,1,1,2
utah,2003,Urban Meyer (10-2),Urban Meyer,10,2,12,1,
utah,2002,Ron McBride (5-6),Ron McBride,5,6,11,1,
utah,2001,Ron McBride (8-4),Ron McBride,8,4,12,1,
utah,2000,Ron McBride (4-7),Ron McBride,4,7,11,1,
vanderbilt,2016,Derek Mason (6-7),Derek Mason,6,7,13,1,
vanderbilt,2015,Derek Mason (4-8),Derek Mason,4,8,12,1,
vanderbilt,2014,Derek Mason (3-9),Derek Mason,3,9,12,1,
vanderbilt,2013,James Franklin (9-4),James Franklin,9,4,13,1,
vanderbilt,2012,James Franklin (9-4),James Franklin,9,4,13,1,
vanderbilt,2011,James Franklin (6-7),James Franklin,6,7,13,1,
vanderbilt,2010,Robbie Caldwell (2-10),Robbie Caldwell,2,10,12,1,
vanderbilt,2009,Bobby Johnson (2-10),Bobby Johnson,2,10,12,1,
vanderbilt,2008,Bobby Johnson (7-6),Bobby Johnson,7,6,13,1,
vanderbilt,2007,Bobby Johnson (5-7),Bobby Johnson,5,7,12,1,
vanderbilt,2006,Bobby Johnson (4-8),Bobby Johnson,4,8,12,1,
vanderbilt,2005,Bobby Johnson (5-6),Bobby Johnson,5,6,11,1,
vanderbilt,2004,Bobby Johnson (2-9),Bobby Johnson,2,9,11,1,
vanderbilt,2003,Bobby Johnson (2-10),Bobby Johnson,2,10,12,1,
vanderbilt,2002,Bobby Johnson (2-10),Bobby Johnson,2,10,12,1,
vanderbilt,2001,Woody Widenhofer (2-9),Woody Widenhofer,2,9,11,1,
vanderbilt,2000,Woody Widenhofer (3-8),Woody Widenhofer,3,8,11,1,
virginia,2016,Bronco Mendenhall (2-10),Bronco Mendenhall,2,10,12,1,
virginia,2015,Mike London (4-8),Mike London,4,8,12,1,
virginia,2014,Mike London (5-7),Mike London,5,7,12,1,
virginia,2013,Mike London (2-10),Mike London,2,10,12,1,
virginia,2012,Mike London (4-8),Mike London,4,8,12,1,
virginia,2011,Mike London (8-5),Mike London,8,5,13,1,
virginia,2010,Mike London (4-8),Mike London,4,8,12,1,
virginia,2009,Al Groh (3-9),Al Groh,3,9,12,1,
virginia,2008,Al Groh (5-7),Al Groh,5,7,12,1,
virginia,2007,Al Groh (9-4),Al Groh,9,4,13,1,
virginia,2006,Al Groh (5-7),Al Groh,5,7,12,1,
virginia,2005,Al Groh (7-5),Al Groh,7,5,12,1,
virginia,2004,Al Groh (8-4),Al Groh,8,4,12,1,
virginia,2003,Al Groh (8-5),Al Groh,8,5,13,1,
virginia,2002,Al Groh (9-5),Al Groh,9,5,14,1,
virginia,2001,Al Groh (5-7),Al Groh,5,7,12,1,
virginia,2000,George Welsh (6-6),George Welsh,6,6,12,1,
virginia-tech,2016,Justin Fuente (10-4),Justin Fuente,10,4,14,1,
virginia-tech,2015,Frank Beamer (7-6),Frank Beamer,7,6,13,1,
virginia-tech,2014,Frank Beamer (7-6),Frank Beamer,7,6,13,1,
virginia-tech,2013,Frank Beamer (8-5),Frank Beamer,8,5,13,1,
virginia-tech,2012,Frank Beamer (7-6),Frank Beamer,7,6,13,1,
virginia-tech,2011,Frank Beamer (11-3),Frank Beamer,11,3,14,1,
virginia-tech,2010,Frank Beamer (11-3),Frank Beamer,11,3,14,1,
virginia-tech,2009,Frank Beamer (10-3),Frank Beamer,10,3,13,1,
virginia-tech,2008,Frank Beamer (10-4),Frank Beamer,10,4,14,1,
virginia-tech,2007,Frank Beamer (11-3),Frank Beamer,11,3,14,1,
virginia-tech,2006,Frank Beamer (10-3),Frank Beamer,10,3,13,1,
virginia-tech,2005,Frank Beamer (11-2),Frank Beamer,11,2,13,1,
virginia-tech,2004,Frank Beamer (10-3),Frank Beamer,10,3,13,1,
virginia-tech,2003,Frank Beamer (8-5),Frank Beamer,8,5,13,1,
virginia-tech,2002,Frank Beamer (10-4),Frank Beamer,10,4,14,1,
virginia-tech,2001,Frank Beamer (8-4),Frank Beamer,8,4,12,1,
virginia-tech,2000,Frank Beamer (11-1),Frank Beamer,11,1,12,1,
wake-forest,2016,Dave Clawson (7-6),Dave Clawson,7,6,13,1,
wake-forest,2015,Dave Clawson (3-9),Dave Clawson,3,9,12,1,
wake-forest,2014,Dave Clawson (3-9),Dave Clawson,3,9,12,1,
wake-forest,2013,Jim Grobe (4-8),Jim Grobe,4,8,12,1,
wake-forest,2012,Jim Grobe (5-7),Jim Grobe,5,7,12,1,
wake-forest,2011,Jim Grobe (6-7),Jim Grobe,6,7,13,1,
wake-forest,2010,Jim Grobe (3-9),Jim Grobe,3,9,12,1,
wake-forest,2009,Jim Grobe (5-7),Jim Grobe,5,7,12,1,
wake-forest,2008,Jim Grobe (8-5),Jim Grobe,8,5,13,1,
wake-forest,2007,Jim Grobe (9-4),Jim Grobe,9,4,13,1,
wake-forest,2006,Jim Grobe (11-3),Jim Grobe,11,3,14,1,
wake-forest,2005,Jim Grobe (4-7),Jim Grobe,4,7,11,1,
wake-forest,2004,Jim Grobe (4-7),Jim Grobe,4,7,11,1,
wake-forest,2003,Jim Grobe (5-7),Jim Grobe,5,7,12,1,
wake-forest,2002,Jim Grobe (7-6),Jim Grobe,7,6,13,1,
wake-forest,2001,Jim Grobe (6-5),Jim Grobe,6,5,11,1,
wake-forest,2000,Jim Caldwell (2-9),Jim Caldwell,2,9,11,1,
washington,2016,Chris Petersen (12-2),Chris Petersen,12,2,14,1,
washington,2015,Chris Petersen (7-6),Chris Petersen,7,6,13,1,
washington,2014,Chris Petersen (8-6),Chris Petersen,8,6,14,1,
washington,2013,"Marques Tuiasosopo (1-0), Steve Sarkisian (8-4)",Steve Sarkisian,8,4,12,2,1
washington,2013,"Marques Tuiasosopo (1-0), Steve Sarkisian (8-4)",Marques Tuiasosopo,1,0,1,1,2
washington,2012,Steve Sarkisian (7-6),Steve Sarkisian,7,6,13,1,
washington,2011,Steve Sarkisian (7-6),Steve Sarkisian,7,6,13,1,
washington,2010,Steve Sarkisian (7-6),Steve Sarkisian,7,6,13,1,
washington,2009,Steve Sarkisian (5-7),Steve Sarkisian,5,7,12,1,
washington,2008,Tyrone Willingham (0-12),Tyrone Willingham,0,12,12,1,
washington,2007,Tyrone Willingham (4-9),Tyrone Willingham,4,9,13,1,
washington,2006,Tyrone Willingham (5-7),Tyrone Willingham,5,7,12,1,
washington,2005,Tyrone Willingham (2-9),Tyrone Willingham,2,9,11,1,
washington,2004,Keith Gilbertson (1-10),Keith Gilbertson,1,10,11,1,
washington,2003,Keith Gilbertson (6-6),Keith Gilbertson,6,6,12,1,
washington,2002,Rick Neuheisel (7-6),Rick Neuheisel,7,6,13,1,
washington,2001,Rick Neuheisel (8-4),Rick Neuheisel,8,4,12,1,
washington,2000,Rick Neuheisel (11-1),Rick Neuheisel,11,1,12,1,
washington-state,2016,Mike Leach (8-5),Mike Leach,8,5,13,1,
washington-state,2015,Mike Leach (9-4),Mike Leach,9,4,13,1,
washington-state,2014,Mike Leach (3-9),Mike Leach,3,9,12,1,
washington-state,2013,Mike Leach (6-7),Mike Leach,6,7,13,1,
washington-state,2012,Mike Leach (3-9),Mike Leach,3,9,12,1,
washington-state,2011,Paul Wulff (4-8),Paul Wulff,4,8,12,1,
washington-state,2010,Paul Wulff (2-10),Paul Wulff,2,10,12,1,
washington-state,2009,Paul Wulff (1-11),Paul Wulff,1,11,12,1,
washington-state,2008,Paul Wulff (2-11),Paul Wulff,2,11,13,1,
washington-state,2007,Bill Doba (5-7),Bill Doba,5,7,12,1,
washington-state,2006,Bill Doba (6-6),Bill Doba,6,6,12,1,
washington-state,2005,Bill Doba (4-7),Bill Doba,4,7,11,1,
washington-state,2004,Bill Doba (5-6),Bill Doba,5,6,11,1,
washington-state,2003,Bill Doba (10-3),Bill Doba,10,3,13,1,
washington-state,2002,Mike Price (10-3),Mike Price,10,3,13,1,
washington-state,2001,Mike Price (10-2),Mike Price,10,2,12,1,
washington-state,2000,Mike Price (4-7),Mike Price,4,7,11,1,
west-virginia,2016,Dana Holgorsen (10-3),Dana Holgorsen,10,3,13,1,
west-virginia,2015,Dana Holgorsen (8-5),Dana Holgorsen,8,5,13,1,
west-virginia,2014,Dana Holgorsen (7-6),Dana Holgorsen,7,6,13,1,
west-virginia,2013,Dana Holgorsen (4-8),Dana Holgorsen,4,8,12,1,
west-virginia,2012,Dana Holgorsen (7-6),Dana Holgorsen,7,6,13,1,
west-virginia,2011,Dana Holgorsen (10-3),Dana Holgorsen,10,3,13,1,
west-virginia,2010,Bill Stewart (9-4),Bill Stewart,9,4,13,1,
west-virginia,2009,Bill Stewart (9-4),Bill Stewart,9,4,13,1,
west-virginia,2008,Bill Stewart (9-4),Bill Stewart,9,4,13,1,
west-virginia,2007,"Bill Stewart (1-0), Rich Rodriguez (10-2)",Rich Rodriguez,10,2,12,2,1
west-virginia,2007,"Bill Stewart (1-0), Rich Rodriguez (10-2)",Bill Stewart,1,0,1,1,2
west-virginia,2006,Rich Rodriguez (11-2),Rich Rodriguez,11,2,13,1,
west-virginia,2005,Rich Rodriguez (11-1),Rich Rodriguez,11,1,12,1,
west-virginia,2004,Rich Rodriguez (8-4),Rich Rodriguez,8,4,12,1,
west-virginia,2003,Rich Rodriguez (8-5),Rich Rodriguez,8,5,13,1,
west-virginia,2002,Rich Rodriguez (9-4),Rich Rodriguez,9,4,13,1,
west-virginia,2001,Rich Rodriguez (3-8),Rich Rodriguez,3,8,11,1,
west-virginia,2000,Don Nehlen (7-5),Don Nehlen,7,5,12,1,
wisconsin,2016,Paul Chryst (11-3),Paul Chryst,11,3,14,1,
wisconsin,2015,Paul Chryst (10-3),Paul Chryst,10,3,13,1,
wisconsin,2014,"Barry Alvarez (1-0), Gary Andersen (10-3)",Gary Andersen,10,3,13,2,1
wisconsin,2014,"Barry Alvarez (1-0), Gary Andersen (10-3)",Barry Alvarez,1,0,1,1,2
wisconsin,2013,Gary Andersen (9-4),Gary Andersen,9,4,13,1,
wisconsin,2012,"Bret Bielema (8-5), Barry Alvarez (0-1)",Barry Alvarez,0,1,1,2,
wisconsin,2012,"Bret Bielema (8-5), Barry Alvarez (0-1)",Bret Bielema,8,5,13,1,
wisconsin,2011,Bret Bielema (11-3),Bret Bielema,11,3,14,1,
wisconsin,2010,Bret Bielema (11-2),Bret Bielema,11,2,13,1,
wisconsin,2009,Bret Bielema (10-3),Bret Bielema,10,3,13,1,
wisconsin,2008,Bret Bielema (7-6),Bret Bielema,7,6,13,1,
wisconsin,2007,Bret Bielema (9-4),Bret Bielema,9,4,13,1,
wisconsin,2006,Bret Bielema (12-1),Bret Bielema,12,1,13,1,
wisconsin,2005,Barry Alvarez (10-3),Barry Alvarez,10,3,13,1,
wisconsin,2004,Barry Alvarez (9-3),Barry Alvarez,9,3,12,1,
wisconsin,2003,Barry Alvarez (7-6),Barry Alvarez,7,6,13,1,
wisconsin,2002,Barry Alvarez (8-6),Barry Alvarez,8,6,14,1,
wisconsin,2001,Barry Alvarez (5-7),Barry Alvarez,5,7,12,1,
wisconsin,2000,Barry Alvarez (9-4),Barry Alvarez,9,4,13,1,
